pathway	category
REACTOME_INTRINSIC_PATHWAY_FOR_APOPTOSIS	Programmed Cell Death
REACTOME_REGULATION_OF_APOPTOSIS	Programmed Cell Death
REACTOME_CASPASE_ACTIVATION_VIA_EXTRINSIC_APOPTOTIC_SIGNALLING_PATHWAY	Programmed Cell Death
REACTOME_APOPTOTIC_EXECUTION_PHASE	Programmed Cell Death
REACTOME_FORMATION_OF_FIBRIN_CLOT_CLOTTING_CASCADE	Hemostasis
REACTOME_CELL_SURFACE_INTERACTIONS_AT_THE_VASCULAR_WALL	Hemostasis
REACTOME_PLATELET_HOMEOSTASIS	Hemostasis
REACTOME_DISSOLUTION_OF_FIBRIN_CLOT	Hemostasis
REACTOME_PLATELET_ADHESION_TO_EXPOSED_COLLAGEN	Hemostasis
REACTOME_PLATELET_ACTIVATION_SIGNALING_AND_AGGREGATION	Hemostasis
REACTOME_FACTORS_INVOLVED_IN_MEGAKARYOCYTE_DEVELOPMENT_AND_PLATELET_PRODUCTION	Hemostasis
REACTOME_BH3_ONLY_PROTEINS_ASSOCIATE_WITH_AND_INACTIVATE_ANTI_APOPTOTIC_BCL_2_MEMBERS	Programmed Cell Death
REACTOME_APOPTOTIC_FACTOR_MEDIATED_RESPONSE	Programmed Cell Death
REACTOME_ACTIVATION_OF_BH3_ONLY_PROTEINS	Programmed Cell Death
REACTOME_TRANSLESION_SYNTHESIS_BY_POLH	DNA Repair
REACTOME_TRANSLESION_SYNTHESIS_BY_POLK	DNA Repair
REACTOME_TERMINATION_OF_TRANSLESION_DNA_SYNTHESIS	DNA Repair
REACTOME_POLB_DEPENDENT_LONG_PATCH_BASE_EXCISION_REPAIR	DNA Repair
REACTOME_PCNA_DEPENDENT_LONG_PATCH_BASE_EXCISION_REPAIR	DNA Repair
REACTOME_ACTIVATION_OF_CASPASES_THROUGH_APOPTOSOME_MEDIATED_CLEAVAGE	Programmed Cell Death
REACTOME_CASPASE_MEDIATED_CLEAVAGE_OF_CYTOSKELETAL_PROTEINS	Programmed Cell Death
REACTOME_APOPTOTIC_CLEAVAGE_OF_CELL_ADHESION_PROTEINS	Programmed Cell Death
REACTOME_RELEASE_OF_APOPTOTIC_FACTORS_FROM_THE_MITOCHONDRIA	Programmed Cell Death
REACTOME_CYTOCHROME_C_MEDIATED_APOPTOTIC_RESPONSE	Programmed Cell Death
REACTOME_SMAC_XIAP_REGULATED_APOPTOTIC_RESPONSE	Programmed Cell Death
REACTOME_G_PROTEIN_MEDIATED_EVENTS	Signal Transduction
REACTOME_DARPP_32_EVENTS	Signal Transduction
REACTOME_G_PROTEIN_ACTIVATION	Signal Transduction
REACTOME_PKA_MEDIATED_PHOSPHORYLATION_OF_CREB	Signal Transduction
REACTOME_CAMK_IV_MEDIATED_PHOSPHORYLATION_OF_CREB	Signal Transduction
REACTOME_ADENYLATE_CYCLASE_ACTIVATING_PATHWAY	Signal Transduction
REACTOME_ADENYLATE_CYCLASE_INHIBITORY_PATHWAY	Signal Transduction
REACTOME_ADENYLATE_CYCLASE_INHIBITORY_PATHWAY	Neuronal System
REACTOME_CA_DEPENDENT_EVENTS	Signal Transduction
REACTOME_SEROTONIN_NEUROTRANSMITTER_RELEASE_CYCLE	Neuronal System
REACTOME_NOREPINEPHRINE_NEUROTRANSMITTER_RELEASE_CYCLE	Neuronal System
REACTOME_GLUTAMATE_NEUROTRANSMITTER_RELEASE_CYCLE	Neuronal System
REACTOME_DOPAMINE_NEUROTRANSMITTER_RELEASE_CYCLE	Neuronal System
REACTOME_ACETYLCHOLINE_NEUROTRANSMITTER_RELEASE_CYCLE	Neuronal System
REACTOME_GABA_SYNTHESIS_RELEASE_REUPTAKE_AND_DEGRADATION	Neuronal System
REACTOME_ACETYLCHOLINE_BINDING_AND_DOWNSTREAM_EVENTS	Neuronal System
REACTOME_GLUTAMATE_BINDING_ACTIVATION_OF_AMPA_RECEPTORS_AND_SYNAPTIC_PLASTICITY	Neuronal System
REACTOME_ACTIVATION_OF_NMDA_RECEPTORS_AND_POSTSYNAPTIC_EVENTS	Neuronal System
REACTOME_ACTIVATION_OF_KAINATE_RECEPTORS_UPON_GLUTAMATE_BINDING	Neuronal System
REACTOME_GABA_RECEPTOR_ACTIVATION	Neuronal System
REACTOME_PRESYNAPTIC_DEPOLARIZATION_AND_CALCIUM_CHANNEL_OPENING	Neuronal System
REACTOME_NEUROTRANSMITTER_RELEASE_CYCLE	Neuronal System
REACTOME_NEUROTRANSMITTER_CLEARANCE	Neuronal System
REACTOME_NEUROTRANSMITTER_RECEPTORS_AND_POSTSYNAPTIC_SIGNAL_TRANSMISSION	Neuronal System
REACTOME_TRANSMISSION_ACROSS_ELECTRICAL_SYNAPSES	Neuronal System
REACTOME_TRANSMISSION_ACROSS_CHEMICAL_SYNAPSES	Neuronal System
REACTOME_POTASSIUM_CHANNELS	Neuronal System
REACTOME_PROTEIN_PROTEIN_INTERACTIONS_AT_SYNAPSES	Neuronal System
REACTOME_SOS_MEDIATED_SIGNALLING	Signal Transduction
REACTOME_MAPK3_ERK1_ACTIVATION	Signal Transduction
REACTOME_MAPK1_ERK2_ACTIVATION	Signal Transduction
REACTOME_INHIBITION_OF_REPLICATION_INITIATION_OF_DAMAGED_DNA_BY_RB1_E2F1	Cell Cycle
REACTOME_E2F_ENABLED_INHIBITION_OF_PRE_REPLICATION_COMPLEX_FORMATION	Cell Cycle
REACTOME_ACTIVATION_OF_BAD_AND_TRANSLOCATION_TO_MITOCHONDRIA	Programmed Cell Death
REACTOME_ACTIVATION_OF_NOXA_AND_TRANSLOCATION_TO_MITOCHONDRIA	Programmed Cell Death
REACTOME_ACTIVATION_OF_PUMA_AND_TRANSLOCATION_TO_MITOCHONDRIA	Programmed Cell Death
REACTOME_ARACHIDONATE_PRODUCTION_FROM_DAG	Hemostasis
REACTOME_ARACHIDONATE_PRODUCTION_FROM_DAG	Signal Transduction
REACTOME_ACTIVATION_OF_NF_KAPPAB_IN_B_CELLS	Immune System
REACTOME_ACTIVATION_OF_RAS_IN_B_CELLS	Immune System
REACTOME_CALCINEURIN_ACTIVATES_NFAT	Immune System
REACTOME_OAS_ANTIVIRAL_RESPONSE	Immune System
REACTOME_REGULATION_OF_SIGNALING_BY_NODAL	Developmental Biology
REACTOME_SPERM_MOTILITY_AND_TAXES	Reproduction
REACTOME_ACROSOME_REACTION_AND_SPERM:OOCYTE_MEMBRANE_BINDING	Reproduction
REACTOME_INTERACTION_WITH_CUMULUS_CELLS_AND_THE_ZONA_PELLUCIDA	Reproduction
REACTOME_SIGNALING_BY_FGFR2_IN_DISEASE	Disease
REACTOME_SIGNALING_BY_FGFR4_IN_DISEASE	Disease
REACTOME_SIGNALING_BY_FGFR1_IN_DISEASE	Disease
REACTOME_SHC1_EVENTS_IN_ERBB2_SIGNALING	Signal Transduction
REACTOME_GRB7_EVENTS_IN_ERBB2_SIGNALING	Signal Transduction
REACTOME_GRB2_EVENTS_IN_ERBB2_SIGNALING	Signal Transduction
REACTOME_PI3K_EVENTS_IN_ERBB2_SIGNALING	Signal Transduction
REACTOME_ERBB2_REGULATES_CELL_MOTILITY	Signal Transduction
REACTOME_ERBB2_ACTIVATES_PTK6_SIGNALING	Signal Transduction
REACTOME_DOWNREGULATION_OF_ERBB2_SIGNALING	Signal Transduction
REACTOME_REGULATION_OF_GENE_EXPRESSION_BY_HYPOXIA_INDUCIBLE_FACTOR	Cellular responses to external stimuli
REACTOME_PI3K_EVENTS_IN_ERBB4_SIGNALING	Signal Transduction
REACTOME_SHC1_EVENTS_IN_ERBB4_SIGNALING	Signal Transduction
REACTOME_NUCLEAR_SIGNALING_BY_ERBB4	Signal Transduction
REACTOME_DOWNREGULATION_OF_ERBB4_SIGNALING	Signal Transduction
REACTOME_CROSS_PRESENTATION_OF_PARTICULATE_EXOGENOUS_ANTIGENS_PHAGOSOMES	Immune System
REACTOME_ENDOSOMAL_VACUOLAR_PATHWAY	Immune System
REACTOME_CROSS_PRESENTATION_OF_SOLUBLE_EXOGENOUS_ANTIGENS_ENDOSOMES	Immune System
REACTOME_AKT_PHOSPHORYLATES_TARGETS_IN_THE_CYTOSOL	Signal Transduction
REACTOME_AKT_PHOSPHORYLATES_TARGETS_IN_THE_NUCLEUS	Signal Transduction
REACTOME_NEGATIVE_REGULATION_OF_THE_PI3K_AKT_NETWORK	Signal Transduction
REACTOME_PTEN_REGULATION	Signal Transduction
REACTOME_SIGNALING_BY_NODAL	Developmental Biology
REACTOME_REGULATION_OF_BETA_CELL_DEVELOPMENT	Developmental Biology
REACTOME_TRANSCRIPTIONAL_REGULATION_OF_WHITE_ADIPOCYTE_DIFFERENTIATION	Developmental Biology
REACTOME_AXON_GUIDANCE	Developmental Biology
REACTOME_TRANSCRIPTIONAL_REGULATION_OF_PLURIPOTENT_STEM_CELLS	Developmental Biology
REACTOME_MYOGENESIS	Developmental Biology
REACTOME_ACTIVATION_OF_HOX_GENES_DURING_DIFFERENTIATION	Developmental Biology
REACTOME_LGI_ADAM_INTERACTIONS	Developmental Biology
REACTOME_KERATINIZATION	Developmental Biology
REACTOME_TRANSCRIPTIONAL_REGULATION_OF_GRANULOPOIESIS	Developmental Biology
REACTOME_PROLACTIN_RECEPTOR_SIGNALING	Immune System
REACTOME_SIGNALING_BY_INTERLEUKINS	Immune System
REACTOME_TNFR2_NON_CANONICAL_NF_KB_PATHWAY	Immune System
REACTOME_INTERFERON_SIGNALING	Immune System
REACTOME_GROWTH_HORMONE_RECEPTOR_SIGNALING	Immune System
REACTOME_IMMUNOREGULATORY_INTERACTIONS_BETWEEN_A_LYMPHOID_AND_A_NON_LYMPHOID_CELL	Immune System
REACTOME_TCR_SIGNALING	Immune System
REACTOME_MHC_CLASS_II_ANTIGEN_PRESENTATION	Immune System
REACTOME_COSTIMULATION_BY_THE_CD28_FAMILY	Immune System
REACTOME_RAP1_SIGNALLING	Immune System
REACTOME_BUTYROPHILIN_BTN_FAMILY_INTERACTIONS	Immune System
REACTOME_CLASS_I_MHC_MEDIATED_ANTIGEN_PROCESSING_PRESENTATION	Immune System
REACTOME_SIGNALING_BY_THE_B_CELL_RECEPTOR_BCR	Immune System
REACTOME_G_PROTEIN_GATED_POTASSIUM_CHANNELS	Neuronal System
REACTOME_CA2PLUS_ACTIVATED_KPLUS_CHANNELS	Neuronal System
REACTOME_INWARDLY_RECTIFYING_KPLUS_CHANNELS	Neuronal System
REACTOME_VOLTAGE_GATED_POTASSIUM_CHANNELS	Neuronal System
REACTOME_TANDEM_PORE_DOMAIN_POTASSIUM_CHANNELS	Neuronal System
REACTOME_REGULATION_BY_C_FLIP	Programmed Cell Death
REACTOME_EXTRINSIC_PATHWAY_OF_FIBRIN_CLOT_FORMATION	Hemostasis
REACTOME_INTRINSIC_PATHWAY_OF_FIBRIN_CLOT_FORMATION	Hemostasis
REACTOME_COMMON_PATHWAY_OF_FIBRIN_CLOT_FORMATION	Hemostasis
REACTOME_RESPIRATORY_ELECTRON_TRANSPORT_ATP_SYNTHESIS_BY_CHEMIOSMOTIC_COUPLING_AND_HEAT_PRODUCTION_BY_UNCOUPLING_PROTEINS	Metabolism
REACTOME_PYRUVATE_METABOLISM_AND_CITRIC_ACID_TCA_CYCLE	Metabolism
REACTOME_MITOCHONDRIAL_IRON_SULFUR_CLUSTER_BIOGENESIS	Metabolism
REACTOME_THE_CITRIC_ACID_TCA_CYCLE_AND_RESPIRATORY_ELECTRON_TRANSPORT	Metabolism
REACTOME_REVERSIBLE_HYDRATION_OF_CARBON_DIOXIDE	Metabolism
REACTOME_INOSITOL_PHOSPHATE_METABOLISM	Metabolism
REACTOME_METABOLISM_OF_NUCLEOTIDES	Metabolism
REACTOME_INTEGRATION_OF_ENERGY_METABOLISM	Metabolism
REACTOME_METABOLISM_OF_PORPHYRINS	Metabolism
REACTOME_METABOLISM_OF_VITAMINS_AND_COFACTORS	Metabolism
REACTOME_METABOLISM_OF_NITRIC_OXIDE:_ENOS_ACTIVATION_AND_REGULATION	Metabolism
REACTOME_BIOLOGICAL_OXIDATIONS	Metabolism
REACTOME_ABACAVIR_TRANSPORT_AND_METABOLISM	Metabolism
REACTOME_CYTOSOLIC_IRON_SULFUR_CLUSTER_ASSEMBLY	Metabolism
REACTOME_METABOLISM_OF_LIPIDS	Metabolism
REACTOME_METABOLISM_OF_AMINO_ACIDS_AND_DERIVATIVES	Metabolism
REACTOME_METABOLISM_OF_CARBOHYDRATES	Metabolism
REACTOME_REGULATION_OF_KIT_SIGNALING	Signal Transduction
REACTOME_BETA_DEFENSINS	Immune System
REACTOME_ALPHA_DEFENSINS	Immune System
REACTOME_FERTILIZATION	Reproduction
REACTOME_MEIOSIS	Reproduction
REACTOME_MEIOSIS	Cell Cycle
REACTOME_COLLAGEN_DEGRADATION	Extracellular matrix organization
REACTOME_ACTIVATION_OF_MATRIX_METALLOPROTEINASES	Extracellular matrix organization
REACTOME_DEGRADATION_OF_THE_EXTRACELLULAR_MATRIX	Extracellular matrix organization
REACTOME_COLLAGEN_FORMATION	Extracellular matrix organization
REACTOME_ELASTIC_FIBRE_FORMATION	Extracellular matrix organization
REACTOME_FIBRONECTIN_MATRIX_FORMATION	Extracellular matrix organization
REACTOME_INTEGRIN_CELL_SURFACE_INTERACTIONS	Extracellular matrix organization
REACTOME_LAMININ_INTERACTIONS	Extracellular matrix organization
REACTOME_NON_INTEGRIN_MEMBRANE_ECM_INTERACTIONS	Extracellular matrix organization
REACTOME_ECM_PROTEOGLYCANS	Extracellular matrix organization
REACTOME_COLLAGEN_BIOSYNTHESIS_AND_MODIFYING_ENZYMES	Extracellular matrix organization
REACTOME_ASSEMBLY_OF_COLLAGEN_FIBRILS_AND_OTHER_MULTIMERIC_STRUCTURES	Extracellular matrix organization
REACTOME_ERYTHROCYTES_TAKE_UP_OXYGEN_AND_RELEASE_CARBON_DIOXIDE	Transport of small molecules
REACTOME_ACYL_CHAIN_REMODELLING_OF_PC	Metabolism
REACTOME_ACYL_CHAIN_REMODELING_OF_CL	Metabolism
REACTOME_ACYL_CHAIN_REMODELLING_OF_PS	Metabolism
REACTOME_ACYL_CHAIN_REMODELLING_OF_PE	Metabolism
REACTOME_ACYL_CHAIN_REMODELING_OF_DAG_AND_TAG	Metabolism
REACTOME_ACYL_CHAIN_REMODELLING_OF_PI	Metabolism
REACTOME_ACYL_CHAIN_REMODELLING_OF_PG	Metabolism
REACTOME_HYDROLYSIS_OF_LPC	Metabolism
REACTOME_SYNTHESIS_OF_PG	Metabolism
REACTOME_SYNTHESIS_OF_PA	Metabolism
REACTOME_SYNTHESIS_OF_PC	Metabolism
REACTOME_SYNTHESIS_OF_PE	Metabolism
REACTOME_SYNTHESIS_OF_PI	Metabolism
REACTOME_SYNTHESIS_OF_PYROPHOSPHATES_IN_THE_CYTOSOL	Metabolism
REACTOME_SYNTHESIS_OF_IP2_IP_AND_INS_IN_THE_CYTOSOL	Metabolism
REACTOME_SYNTHESIS_OF_IP3_AND_IP4_IN_THE_CYTOSOL	Metabolism
REACTOME_SYNTHESIS_OF_PIPS_AT_THE_ER_MEMBRANE	Metabolism
REACTOME_SYNTHESIS_OF_PIPS_AT_THE_PLASMA_MEMBRANE	Metabolism
REACTOME_SYNTHESIS_OF_PIPS_AT_THE_GOLGI_MEMBRANE	Metabolism
REACTOME_SYNTHESIS_OF_PIPS_AT_THE_EARLY_ENDOSOME_MEMBRANE	Metabolism
REACTOME_SYNTHESIS_OF_PIPS_AT_THE_LATE_ENDOSOME_MEMBRANE	Metabolism
REACTOME_GLYCEROPHOSPHOLIPID_CATABOLISM	Metabolism
REACTOME_GLYCEROPHOSPHOLIPID_BIOSYNTHESIS	Metabolism
REACTOME_PI_METABOLISM	Metabolism
REACTOME_MEIOTIC_SYNAPSIS	Reproduction
REACTOME_MEIOTIC_SYNAPSIS	Cell Cycle
REACTOME_MEIOTIC_RECOMBINATION	Reproduction
REACTOME_MEIOTIC_RECOMBINATION	Cell Cycle
REACTOME_NEPHRIN_FAMILY_INTERACTIONS	Cell-Cell communication
REACTOME_SIGNAL_REGULATORY_PROTEIN_FAMILY_INTERACTIONS	Cell-Cell communication
REACTOME_CELL_JUNCTION_ORGANIZATION	Cell-Cell communication
REACTOME_TRANSCRIPTION_OF_E2F_TARGETS_UNDER_NEGATIVE_CONTROL_BY_DREAM_COMPLEX	Cell Cycle
REACTOME_TRANSCRIPTION_OF_E2F_TARGETS_UNDER_NEGATIVE_CONTROL_BY_P107_RBL1_AND_P130_RBL2_IN_COMPLEX_WITH_HDAC1	Cell Cycle
REACTOME_METHYLATION	Metabolism
REACTOME_CYTOSOLIC_SULFONATION_OF_SMALL_MOLECULES	Metabolism
REACTOME_AMINO_ACID_CONJUGATION	Metabolism
REACTOME_GLUCURONIDATION	Metabolism
REACTOME_GLUTATHIONE_CONJUGATION	Metabolism
REACTOME_TRANSPORT_AND_SYNTHESIS_OF_PAPS	Metabolism
REACTOME_GLUTATHIONE_SYNTHESIS_AND_RECYCLING	Metabolism
REACTOME_MOLECULES_ASSOCIATED_WITH_ELASTIC_FIBRES	Extracellular matrix organization
REACTOME_PRE_NOTCH_EXPRESSION_AND_PROCESSING	Signal Transduction
REACTOME_SIGNALING_BY_NOTCH1	Signal Transduction
REACTOME_SIGNALING_BY_NOTCH2	Signal Transduction
REACTOME_SIGNALING_BY_NOTCH3	Signal Transduction
REACTOME_SIGNALING_BY_NOTCH4	Signal Transduction
REACTOME_EXTENSION_OF_TELOMERES	Cell Cycle
REACTOME_INTERCONVERSION_OF_NUCLEOTIDE_DI_AND_TRIPHOSPHATES	Metabolism
REACTOME_NUCLEOBASE_CATABOLISM	Metabolism
REACTOME_NUCLEOBASE_BIOSYNTHESIS	Metabolism
REACTOME_NUCLEOTIDE_SALVAGE	Metabolism
REACTOME_TRANSCRIPTIONAL_ACTIVATION_OF_MITOCHONDRIAL_BIOGENESIS	Organelle biogenesis and maintenance
REACTOME_ACTIVATION_OF_PPARGC1A_PGC_1ALPHA_BY_PHOSPHORYLATION	Organelle biogenesis and maintenance
REACTOME_CRISTAE_FORMATION	Organelle biogenesis and maintenance
REACTOME_TRANSPORT_OF_THE_SLBP_DEPENDANT_MATURE_MRNA	Metabolism of RNA
REACTOME_CONJUGATION_OF_BENZOATE_WITH_GLYCINE	Metabolism
REACTOME_REMOVAL_OF_AMINOTERMINAL_PROPEPTIDES_FROM_GAMMA_CARBOXYLATED_PROTEINS	Metabolism of proteins
REACTOME_IRF3_MEDIATED_ACTIVATION_OF_TYPE_1_IFN	Immune System
REACTOME_RIP_MEDIATED_NFKB_ACTIVATION_VIA_ZBP1	Immune System
REACTOME_SULFIDE_OXIDATION_TO_SULFATE	Metabolism
REACTOME_METHIONINE_SALVAGE_PATHWAY	Metabolism
REACTOME_DEGRADATION_OF_CYSTEINE_AND_HOMOCYSTEINE	Metabolism
REACTOME_SIGNALING_BY_NOTCH	Signal Transduction
REACTOME_MTOR_SIGNALLING	Signal Transduction
REACTOME_SIGNALING_BY_RHO_GTPASES	Signal Transduction
REACTOME_SIGNALING_BY_WNT	Signal Transduction
REACTOME_SIGNALING_BY_HIPPO	Signal Transduction
REACTOME_SIGNALING_BY_LEPTIN	Signal Transduction
REACTOME_INTEGRIN_SIGNALING	Hemostasis
REACTOME_INTEGRIN_SIGNALING	Signal Transduction
REACTOME_SIGNALING_BY_GPCR	Signal Transduction
REACTOME_SIGNALING_BY_HEDGEHOG	Signal Transduction
REACTOME_MAPK_FAMILY_SIGNALING_CASCADES	Signal Transduction
REACTOME_DEATH_RECEPTOR_SIGNALLING	Signal Transduction
REACTOME_SIGNALING_BY_ERYTHROPOIETIN	Signal Transduction
REACTOME_INTRACELLULAR_SIGNALING_BY_SECOND_MESSENGERS	Signal Transduction
REACTOME_SIGNALING_BY_NON_RECEPTOR_TYROSINE_KINASES	Signal Transduction
REACTOME_SIGNALING_BY_NUCLEAR_RECEPTORS	Signal Transduction
REACTOME_SIGNALING_BY_RECEPTOR_TYROSINE_KINASES	Signal Transduction
REACTOME_SIGNALING_BY_TGF_BETA_FAMILY_MEMBERS	Signal Transduction
REACTOME_EARLY_PHASE_OF_HIV_LIFE_CYCLE	Disease
REACTOME_2_LTR_CIRCLE_FORMATION	Disease
REACTOME_INTEGRATION_OF_PROVIRUS	Disease
REACTOME_BUDDING_AND_MATURATION_OF_HIV_VIRION	Disease
REACTOME_TRANSCRIPTION_OF_THE_HIV_GENOME	Disease
REACTOME_ASSEMBLY_OF_THE_HIV_VIRION	Disease
REACTOME_HIV_LIFE_CYCLE	Disease
REACTOME_HOST_INTERACTIONS_OF_HIV_FACTORS	Disease
REACTOME_THE_ROLE_OF_NEF_IN_HIV_1_REPLICATION_AND_DISEASE_PATHOGENESIS	Disease
REACTOME_INTERACTIONS_OF_VPR_WITH_HOST_CELLULAR_PROTEINS	Disease
REACTOME_INTERACTIONS_OF_REV_WITH_HOST_CELLULAR_PROTEINS	Disease
REACTOME_VIF_MEDIATED_DEGRADATION_OF_APOBEC3G	Disease
REACTOME_APOBEC3G_MEDIATED_RESISTANCE_TO_HIV_1_INFECTION	Disease
REACTOME_KERATAN_SULFATE_KERATIN_METABOLISM	Metabolism
REACTOME_HEPARAN_SULFATE_HEPARIN_HS_GAG_METABOLISM	Metabolism
REACTOME_CHONDROITIN_SULFATE_DERMATAN_SULFATE_METABOLISM	Metabolism
REACTOME_HYALURONAN_METABOLISM	Metabolism
REACTOME_SYNTHESIS_OF_GLYCOSYLPHOSPHATIDYLINOSITOL_GPI	Metabolism of proteins
REACTOME_ATTACHMENT_OF_GPI_ANCHOR_TO_UPAR	Metabolism of proteins
REACTOME_FORMATION_OF_ATP_BY_CHEMIOSMOTIC_COUPLING	Metabolism
REACTOME_MITOCHONDRIAL_UNCOUPLING_PROTEINS	Metabolism
REACTOME_RESPIRATORY_ELECTRON_TRANSPORT	Metabolism
REACTOME_PKA_ACTIVATION_IN_GLUCAGON_SIGNALLING	Metabolism
REACTOME_PKA_MEDIATED_PHOSPHORYLATION_OF_KEY_METABOLIC_FACTORS	Metabolism
REACTOME_GLUCAGON_SIGNALING_IN_METABOLIC_REGULATION	Metabolism
REACTOME_AMPK_INHIBITS_CHREBP_TRANSCRIPTIONAL_ACTIVATION_ACTIVITY	Metabolism
REACTOME_CHREBP_ACTIVATES_METABOLIC_GENE_EXPRESSION	Metabolism
REACTOME_PP2A_MEDIATED_DEPHOSPHORYLATION_OF_KEY_METABOLIC_FACTORS	Metabolism
REACTOME_REGULATION_OF_INSULIN_SECRETION	Metabolism
REACTOME_KERATAN_SULFATE_BIOSYNTHESIS	Metabolism
REACTOME_KERATAN_SULFATE_DEGRADATION	Metabolism
REACTOME_A_TETRASACCHARIDE_LINKER_SEQUENCE_IS_REQUIRED_FOR_GAG_SYNTHESIS	Metabolism
REACTOME_HS_GAG_BIOSYNTHESIS	Metabolism
REACTOME_HS_GAG_DEGRADATION	Metabolism
REACTOME_GAMMA_CARBOXYLATION_TRANSPORT_AND_AMINO_TERMINAL_CLEAVAGE_OF_PROTEINS	Metabolism of proteins
REACTOME_THE_ACTIVATION_OF_ARYLSULFATASES	Metabolism of proteins
REACTOME_SYNTHESIS_OF_DIPHTHAMIDE_EEF2	Metabolism of proteins
REACTOME_CELL_CYCLE_MITOTIC	Cell Cycle
REACTOME_CELL_CYCLE_CHECKPOINTS	Cell Cycle
REACTOME_CHROMOSOME_MAINTENANCE	Cell Cycle
REACTOME_DISEASES_OF_GLYCOSYLATION	Disease
REACTOME_DISEASES_OF_IMMUNE_SYSTEM	Disease
REACTOME_DISEASES_OF_MISMATCH_REPAIR_MMR	Disease
REACTOME_DISORDERS_OF_TRANSMEMBRANE_TRANSPORTERS	Disease
REACTOME_DISEASES_OF_SIGNAL_TRANSDUCTION	Disease
REACTOME_INFECTIOUS_DISEASE	Disease
REACTOME_DISEASES_OF_METABOLISM	Disease
REACTOME_NEURODEGENERATIVE_DISEASES	Disease
REACTOME_PERVASIVE_DEVELOPMENTAL_DISORDERS	Disease
REACTOME_SIGNALING_BY_EGFRVIII_IN_CANCER	Disease
REACTOME_SIGNALING_BY_LIGAND_RESPONSIVE_EGFR_VARIANTS_IN_CANCER	Disease
REACTOME_NEF_MEDIATED_DOWNREGULATION_OF_MHC_CLASS_I_COMPLEX_CELL_SURFACE_EXPRESSION	Disease
REACTOME_NEF_MEDIATED_CD4_DOWN_REGULATION	Disease
REACTOME_NEF_MEDIATED_CD8_DOWN_REGULATION	Disease
REACTOME_NEF_MEDIATES_DOWN_MODULATION_OF_CELL_SURFACE_RECEPTORS_BY_RECRUITING_THEM_TO_CLATHRIN_ADAPTERS	Disease
REACTOME_NEF_AND_SIGNAL_TRANSDUCTION	Disease
REACTOME_COLLAGEN_CHAIN_TRIMERIZATION	Extracellular matrix organization
REACTOME_MTORC1_MEDIATED_SIGNALLING	Signal Transduction
REACTOME_ENERGY_DEPENDENT_REGULATION_OF_MTOR_BY_LKB1_AMPK	Signal Transduction
REACTOME_ACTIVATION_OF_GENE_EXPRESSION_BY_SREBF_SREBP	Metabolism
REACTOME_TAK1_ACTIVATES_NFKB_BY_PHOSPHORYLATION_AND_ACTIVATION_OF_IKKS_COMPLEX	Immune System
REACTOME_IRAK1_RECRUITS_IKK_COMPLEX	Immune System
REACTOME_IRAK2_MEDIATED_ACTIVATION_OF_TAK1_COMPLEX	Immune System
REACTOME_TRIF_TICAM1_MEDIATED_TLR4_SIGNALING	Immune System
REACTOME_SIGNALING_BY_NTRK1_TRKA	Signal Transduction
REACTOME_SIGNALING_BY_NTRK2_TRKB	Signal Transduction
REACTOME_SIGNALING_BY_NTRK3_TRKC	Signal Transduction
REACTOME_INITIAL_TRIGGERING_OF_COMPLEMENT	Immune System
REACTOME_TERMINAL_PATHWAY_OF_COMPLEMENT	Immune System
REACTOME_ACTIVATION_OF_C3_AND_C5	Immune System
REACTOME_FICOLINS_BIND_TO_REPETITIVE_CARBOHYDRATE_STRUCTURES_ON_THE_TARGET_CELL_SURFACE	Immune System
REACTOME_CREATION_OF_C4_AND_C2_ACTIVATORS	Immune System
REACTOME_ALTERNATIVE_COMPLEMENT_ACTIVATION	Immune System
REACTOME_LECTIN_PATHWAY_OF_COMPLEMENT_ACTIVATION	Immune System
REACTOME_P38MAPK_EVENTS	Signal Transduction
REACTOME_ABORTIVE_ELONGATION_OF_HIV_1_TRANSCRIPT_IN_THE_ABSENCE_OF_TAT	Disease
REACTOME_FORMATION_OF_HIV_ELONGATION_COMPLEX_IN_THE_ABSENCE_OF_HIV_TAT	Disease
REACTOME_HIV_ELONGATION_ARREST_AND_RECOVERY	Disease
REACTOME_MYD88_CASCADE_INITIATED_ON_PLASMA_MEMBRANE	Immune System
REACTOME_TICAM1_RIP1_MEDIATED_IKK_COMPLEX_RECRUITMENT	Immune System
REACTOME_TLR3_MEDIATED_TICAM1_DEPENDENT_PROGRAMMED_CELL_DEATH	Immune System
REACTOME_TICAM1_DEPENDENT_ACTIVATION_OF_IRF3_IRF7	Immune System
REACTOME_TICAM1_TRAF6_DEPENDENT_INDUCTION_OF_TAK1_COMPLEX	Immune System
REACTOME_ROS_AND_RNS_PRODUCTION_IN_PHAGOCYTES	Immune System
REACTOME_COMPLEMENT_CASCADE	Immune System
REACTOME_NUCLEOTIDE_BINDING_DOMAIN_LEUCINE_RICH_REPEAT_CONTAINING_RECEPTOR_NLR_SIGNALING_PATHWAYS	Immune System
REACTOME_TOLL_LIKE_RECEPTOR_CASCADES	Immune System
REACTOME_DDX58_IFIH1_MEDIATED_INDUCTION_OF_INTERFERON_ALPHA_BETA	Immune System
REACTOME_CYTOSOLIC_SENSORS_OF_PATHOGEN_ASSOCIATED_DNA	Immune System
REACTOME_FCGAMMA_RECEPTOR_FCGR_DEPENDENT_PHAGOCYTOSIS	Immune System
REACTOME_DAP12_INTERACTIONS	Immune System
REACTOME_FC_EPSILON_RECEPTOR_FCERI_SIGNALING	Immune System
REACTOME_C_TYPE_LECTIN_RECEPTORS_CLRS	Immune System
REACTOME_NEUTROPHIL_DEGRANULATION	Immune System
REACTOME_ANTIMICROBIAL_PEPTIDES	Immune System
REACTOME_ADVANCED_GLYCOSYLATION_ENDPRODUCT_RECEPTOR_SIGNALING	Immune System
REACTOME_HOST_INTERACTIONS_WITH_INFLUENZA_FACTORS	Disease
REACTOME_EXPORT_OF_VIRAL_RIBONUCLEOPROTEINS_FROM_NUCLEUS	Disease
REACTOME_CYTOKINE_SIGNALING_IN_IMMUNE_SYSTEM	Immune System
REACTOME_ADAPTIVE_IMMUNE_SYSTEM	Immune System
REACTOME_INNATE_IMMUNE_SYSTEM	Immune System
REACTOME_VIRAL_MESSENGER_RNA_SYNTHESIS	Disease
REACTOME_NOD1_2_SIGNALING_PATHWAY	Immune System
REACTOME_INFLAMMASOMES	Immune System
REACTOME_TOXICITY_OF_BOTULINUM_TOXIN_TYPE_D_BONT_D	Disease
REACTOME_TOLL_LIKE_RECEPTOR_4_TLR4_CASCADE	Immune System
REACTOME_TRAFFICKING_AND_PROCESSING_OF_ENDOSOMAL_TLR	Immune System
REACTOME_TOLL_LIKE_RECEPTOR_9_TLR9_CASCADE	Immune System
REACTOME_REGULATION_OF_TLR_BY_ENDOGENOUS_LIGAND	Immune System
REACTOME_TRAF3_DEPENDENT_IRF_ACTIVATION_PATHWAY	Immune System
REACTOME_TRAF6_MEDIATED_IRF7_ACTIVATION	Immune System
REACTOME_TRAF6_MEDIATED_NF_KB_ACTIVATION	Immune System
REACTOME_NF_KB_ACTIVATION_THROUGH_FADD_RIP_1_PATHWAY_MEDIATED_BY_CASPASE_8_AND_10	Immune System
REACTOME_NEGATIVE_REGULATORS_OF_DDX58_IFIH1_SIGNALING	Immune System
REACTOME_FRS2_MEDIATED_ACTIVATION	Signal Transduction
REACTOME_ARMS_MEDIATED_ACTIVATION	Signal Transduction
REACTOME_TGF_BETA_RECEPTOR_SIGNALING_ACTIVATES_SMADS	Signal Transduction
REACTOME_TGF_BETA_RECEPTOR_SIGNALING_IN_EMT_EPITHELIAL_TO_MESENCHYMAL_TRANSITION	Signal Transduction
REACTOME_TRANSCRIPTIONAL_ACTIVITY_OF_SMAD2_SMAD3:SMAD4_HETEROTRIMER	Gene expression (Transcription)
REACTOME_TRANSCRIPTIONAL_ACTIVITY_OF_SMAD2_SMAD3:SMAD4_HETEROTRIMER	Signal Transduction
REACTOME_APC_C:CDH1_MEDIATED_DEGRADATION_OF_CDC20_AND_OTHER_APC_C:CDH1_TARGETED_PROTEINS_IN_LATE_MITOSIS_EARLY_G1	Cell Cycle
REACTOME_CONVERSION_FROM_APC_C:CDC20_TO_APC_C:CDH1_IN_LATE_ANAPHASE	Cell Cycle
REACTOME_ACTIVATION_OF_APC_C_AND_APC_C:CDC20_MEDIATED_DEGRADATION_OF_MITOTIC_PROTEINS	Cell Cycle
REACTOME_PROCESSIVE_SYNTHESIS_ON_THE_C_STRAND_OF_THE_TELOMERE	Cell Cycle
REACTOME_PLASMA_LIPOPROTEIN_ASSEMBLY	Transport of small molecules
REACTOME_PLASMA_LIPOPROTEIN_REMODELING	Transport of small molecules
REACTOME_PLASMA_LIPOPROTEIN_CLEARANCE	Transport of small molecules
REACTOME_INHIBITION_OF_THE_PROTEOLYTIC_ACTIVITY_OF_APC_C_REQUIRED_FOR_THE_ONSET_OF_ANAPHASE_BY_MITOTIC_SPINDLE_CHECKPOINT_COMPONENTS	Cell Cycle
REACTOME_PHOSPHORYLATION_OF_EMI1	Cell Cycle
REACTOME_APC_C:CDC20_MEDIATED_DEGRADATION_OF_CYCLIN_B	Cell Cycle
REACTOME_PHOSPHORYLATION_OF_THE_APC_C	Cell Cycle
REACTOME_NUCLEAR_IMPORT_OF_REV_PROTEIN	Disease
REACTOME_GAB1_SIGNALOSOME	Signal Transduction
REACTOME_SHC1_EVENTS_IN_EGFR_SIGNALING	Signal Transduction
REACTOME_EGFR_DOWNREGULATION	Signal Transduction
REACTOME_EGFR_INTERACTS_WITH_PHOSPHOLIPASE_C_GAMMA	Signal Transduction
REACTOME_CHONDROITIN_SULFATE_BIOSYNTHESIS	Metabolism
REACTOME_DERMATAN_SULFATE_BIOSYNTHESIS	Metabolism
REACTOME_CS_DS_DEGRADATION	Metabolism
REACTOME_APC_CDC20_MEDIATED_DEGRADATION_OF_NEK2A	Cell Cycle
REACTOME_TELOMERE_EXTENSION_BY_TELOMERASE	Cell Cycle
REACTOME_TELOMERE_C_STRAND_LAGGING_STRAND_SYNTHESIS	Cell Cycle
REACTOME_TOLL_LIKE_RECEPTOR_TLR1:TLR2_CASCADE	Immune System
REACTOME_IRF3_MEDIATED_INDUCTION_OF_TYPE_I_IFN	Immune System
REACTOME_ZBP1_DAI_MEDIATED_INDUCTION_OF_TYPE_I_IFNS	Immune System
REACTOME_STING_MEDIATED_INDUCTION_OF_HOST_IMMUNE_RESPONSES	Immune System
REACTOME_DEX_H_BOX_HELICASES_ACTIVATE_TYPE_I_IFN_AND_INFLAMMATORY_CYTOKINES_PRODUCTION	Immune System
REACTOME_LRR_FLII_INTERACTING_PROTEIN_1_LRRFIP1_ACTIVATES_TYPE_I_IFN_PRODUCTION	Immune System
REACTOME_REGULATION_OF_INNATE_IMMUNE_RESPONSES_TO_CYTOSOLIC_DNA	Immune System
REACTOME_SIGNALING_BY_CYTOSOLIC_FGFR1_FUSION_MUTANTS	Disease
REACTOME_SIGNALING_BY_FGFR2_IIIA_TM	Disease
REACTOME_MITOCHONDRIAL_BIOGENESIS	Organelle biogenesis and maintenance
REACTOME_CILIUM_ASSEMBLY	Organelle biogenesis and maintenance
REACTOME_REGULATION_OF_GENE_EXPRESSION_IN_LATE_STAGE_BRANCHING_MORPHOGENESIS_PANCREATIC_BUD_PRECURSOR_CELLS	Developmental Biology
REACTOME_REGULATION_OF_GENE_EXPRESSION_IN_BETA_CELLS	Developmental Biology
REACTOME_REGULATION_OF_GENE_EXPRESSION_IN_ENDOCRINE_COMMITTED_NEUROG3PLUS_PROGENITOR_CELLS	Developmental Biology
REACTOME_REGULATION_OF_GENE_EXPRESSION_IN_EARLY_PANCREATIC_PRECURSOR_CELLS	Developmental Biology
REACTOME_DOWNSTREAM_SIGNAL_TRANSDUCTION	Signal Transduction
REACTOME_NGF_INDEPENDANT_TRKA_ACTIVATION	Signal Transduction
REACTOME_RETROGRADE_NEUROTROPHIN_SIGNALLING	Signal Transduction
REACTOME_ACTIVATION_OF_TRKA_RECEPTORS	Signal Transduction
REACTOME_SIGNALLING_TO_ERKS	Signal Transduction
REACTOME_PI3K_AKT_ACTIVATION	Signal Transduction
REACTOME_NUCLEAR_EVENTS_KINASE_AND_TRANSCRIPTION_FACTOR_ACTIVATION	Signal Transduction
REACTOME_SIGNALLING_TO_RAS	Signal Transduction
REACTOME_PROLONGED_ERK_ACTIVATION_EVENTS	Signal Transduction
REACTOME_SIGNALLING_TO_P38_VIA_RIT_AND_RIN	Signal Transduction
REACTOME_HEME_BIOSYNTHESIS	Metabolism
REACTOME_HEME_DEGRADATION	Metabolism
REACTOME_SIGNALING_BY_FGFR1	Signal Transduction
REACTOME_SIGNALING_BY_FGFR2	Signal Transduction
REACTOME_SIGNALING_BY_FGFR3	Signal Transduction
REACTOME_SIGNALING_BY_FGFR4	Signal Transduction
REACTOME_FGFR3B_LIGAND_BINDING_AND_ACTIVATION	Signal Transduction
REACTOME_FGFR2C_LIGAND_BINDING_AND_ACTIVATION	Signal Transduction
REACTOME_FGFR2B_LIGAND_BINDING_AND_ACTIVATION	Signal Transduction
REACTOME_FGFR1B_LIGAND_BINDING_AND_ACTIVATION	Signal Transduction
REACTOME_FGFR1C_LIGAND_BINDING_AND_ACTIVATION	Signal Transduction
REACTOME_GAP_JUNCTION_ASSEMBLY	Vesicle-mediated transport
REACTOME_GAP_JUNCTION_DEGRADATION	Vesicle-mediated transport
REACTOME_TRANSPORT_OF_CONNEXONS_TO_THE_PLASMA_MEMBRANE	Vesicle-mediated transport
REACTOME_PRE_NOTCH_PROCESSING_IN_THE_ENDOPLASMIC_RETICULUM	Signal Transduction
REACTOME_PRE_NOTCH_PROCESSING_IN_GOLGI	Signal Transduction
REACTOME_SYNTHESIS_OF_BILE_ACIDS_AND_BILE_SALTS_VIA_7ALPHA_HYDROXYCHOLESTEROL	Metabolism
REACTOME_SYNTHESIS_OF_BILE_ACIDS_AND_BILE_SALTS_VIA_24_HYDROXYCHOLESTEROL	Metabolism
REACTOME_SYNTHESIS_OF_BILE_ACIDS_AND_BILE_SALTS_VIA_27_HYDROXYCHOLESTEROL	Metabolism
REACTOME_P75NTR_RECRUITS_SIGNALLING_COMPLEXES	Signal Transduction
REACTOME_NF_KB_IS_ACTIVATED_AND_SIGNALS_SURVIVAL	Signal Transduction
REACTOME_P75NTR_SIGNALS_VIA_NF_KB	Signal Transduction
REACTOME_P75NTR_NEGATIVELY_REGULATES_CELL_CYCLE_VIA_SC1	Signal Transduction
REACTOME_REGULATED_PROTEOLYSIS_OF_P75NTR	Signal Transduction
REACTOME_P75NTR_REGULATES_AXONOGENESIS	Signal Transduction
REACTOME_CELL_DEATH_SIGNALLING_VIA_NRAGE_NRIF_AND_NADE	Signal Transduction
REACTOME_RECYCLING_OF_BILE_ACIDS_AND_SALTS	Metabolism
REACTOME_SYNTHESIS_OF_BILE_ACIDS_AND_BILE_SALTS	Metabolism
REACTOME_VEGF_LIGAND_RECEPTOR_INTERACTIONS	Signal Transduction
REACTOME_RHO_GTPASE_CYCLE	Signal Transduction
REACTOME_RHO_GTPASE_EFFECTORS	Signal Transduction
REACTOME_BETA_CATENIN_PHOSPHORYLATION_CASCADE	Signal Transduction
REACTOME_REPRESSION_OF_WNT_TARGET_GENES	Signal Transduction
REACTOME_RHO_GTPASES_ACTIVATE_PKNS	Signal Transduction
REACTOME_RHO_GTPASES_ACTIVATE_CIT	Signal Transduction
REACTOME_RHO_GTPASES_ACTIVATE_KTN1	Signal Transduction
REACTOME_RHO_GTPASES_ACTIVATE_IQGAPS	Signal Transduction
REACTOME_RHO_GTPASES_ACTIVATE_ROCKS	Signal Transduction
REACTOME_RHO_GTPASES_ACTIVATE_PAKS	Signal Transduction
REACTOME_RHO_GTPASES_ACTIVATE_WASPS_AND_WAVES	Signal Transduction
REACTOME_RHO_GTPASES_ACTIVATE_FORMINS	Signal Transduction
REACTOME_RHO_GTPASES_ACTIVATE_RHOTEKIN_AND_RHOPHILINS	Signal Transduction
REACTOME_RHO_GTPASES_ACTIVATE_NADPH_OXIDASES	Signal Transduction
REACTOME_DEGRADATION_OF_BETA_CATENIN_BY_THE_DESTRUCTION_COMPLEX	Signal Transduction
REACTOME_TCF_DEPENDENT_SIGNALING_IN_RESPONSE_TO_WNT	Signal Transduction
REACTOME_WNT_LIGAND_BIOGENESIS_AND_TRAFFICKING	Signal Transduction
REACTOME_BETA_CATENIN_INDEPENDENT_WNT_SIGNALING	Signal Transduction
REACTOME_ANDROGEN_BIOSYNTHESIS	Metabolism
REACTOME_ESTROGEN_BIOSYNTHESIS	Metabolism
REACTOME_MINERALOCORTICOID_BIOSYNTHESIS	Metabolism
REACTOME_GLUCOCORTICOID_BIOSYNTHESIS	Metabolism
REACTOME_PREGNENOLONE_BIOSYNTHESIS	Metabolism
REACTOME_NICOTINAMIDE_SALVAGING	Metabolism
REACTOME_COBALAMIN_CBL_VITAMIN_B12_TRANSPORT_AND_METABOLISM	Metabolism
REACTOME_METABOLISM_OF_FOLATE_AND_PTERINES	Metabolism
REACTOME_BIOTIN_TRANSPORT_AND_METABOLISM	Metabolism
REACTOME_NICOTINATE_METABOLISM	Metabolism
REACTOME_VITAMIN_B1_THIAMIN_METABOLISM	Metabolism
REACTOME_VITAMIN_C_ASCORBATE_METABOLISM	Metabolism
REACTOME_VITAMIN_B2_RIBOFLAVIN_METABOLISM	Metabolism
REACTOME_VITAMIN_B5_PANTOTHENATE_METABOLISM	Metabolism
REACTOME_MOLYBDENUM_COFACTOR_BIOSYNTHESIS	Metabolism
REACTOME_METABOLISM_OF_WATER_SOLUBLE_VITAMINS_AND_COFACTORS	Metabolism
REACTOME_METABOLISM_OF_FAT_SOLUBLE_VITAMINS	Metabolism
REACTOME_METABOLISM_OF_COFACTORS	Metabolism
REACTOME_NOTCH1_INTRACELLULAR_DOMAIN_REGULATES_TRANSCRIPTION	Signal Transduction
REACTOME_ACTIVATED_NOTCH1_TRANSMITS_SIGNAL_TO_THE_NUCLEUS	Signal Transduction
REACTOME_NOTCH2_INTRACELLULAR_DOMAIN_REGULATES_TRANSCRIPTION	Signal Transduction
REACTOME_NOTCH2_ACTIVATION_AND_TRANSMISSION_OF_SIGNAL_TO_THE_NUCLEUS	Signal Transduction
REACTOME_CREB_PHOSPHORYLATION	Signal Transduction
REACTOME_CREB_PHOSPHORYLATION	Immune System
REACTOME_ERKS_ARE_INACTIVATED	Signal Transduction
REACTOME_ERKS_ARE_INACTIVATED	Immune System
REACTOME_COENZYME_A_BIOSYNTHESIS	Metabolism
REACTOME_COPII_MEDIATED_VESICLE_TRANSPORT	Metabolism of proteins
REACTOME_COPII_MEDIATED_VESICLE_TRANSPORT	Vesicle-mediated transport
REACTOME_CARGO_CONCENTRATION_IN_THE_ER	Metabolism of proteins
REACTOME_CARGO_CONCENTRATION_IN_THE_ER	Vesicle-mediated transport
REACTOME_COPI_MEDIATED_ANTEROGRADE_TRANSPORT	Metabolism of proteins
REACTOME_COPI_MEDIATED_ANTEROGRADE_TRANSPORT	Vesicle-mediated transport
REACTOME_TRANSLOCATION_OF_SLC2A4_GLUT4_TO_THE_PLASMA_MEMBRANE	Vesicle-mediated transport
REACTOME_GAP_JUNCTION_TRAFFICKING_AND_REGULATION	Vesicle-mediated transport
REACTOME_ER_TO_GOLGI_ANTEROGRADE_TRANSPORT	Metabolism of proteins
REACTOME_ER_TO_GOLGI_ANTEROGRADE_TRANSPORT	Vesicle-mediated transport
REACTOME_TRANS_GOLGI_NETWORK_VESICLE_BUDDING	Vesicle-mediated transport
REACTOME_INTRA_GOLGI_AND_RETROGRADE_GOLGI_TO_ER_TRAFFIC	Vesicle-mediated transport
REACTOME_CLATHRIN_MEDIATED_ENDOCYTOSIS	Vesicle-mediated transport
REACTOME_RAB_REGULATION_OF_TRAFFICKING	Vesicle-mediated transport
REACTOME_ENDOSOMAL_SORTING_COMPLEX_REQUIRED_FOR_TRANSPORT_ESCRT	Vesicle-mediated transport
REACTOME_LYSOSOME_VESICLE_BIOGENESIS	Vesicle-mediated transport
REACTOME_GOLGI_ASSOCIATED_VESICLE_BIOGENESIS	Vesicle-mediated transport
REACTOME_WNT_MEDIATED_ACTIVATION_OF_DVL	Signal Transduction
REACTOME_FORMATION_OF_THE_BETA_CATENIN:TCF_TRANSACTIVATING_COMPLEX	Signal Transduction
REACTOME_DEACTIVATION_OF_THE_BETA_CATENIN_TRANSACTIVATING_COMPLEX	Signal Transduction
REACTOME_NEGATIVE_REGULATION_OF_TCF_DEPENDENT_SIGNALING_BY_WNT_LIGAND_ANTAGONISTS	Signal Transduction
REACTOME_DEGRADATION_OF_AXIN	Signal Transduction
REACTOME_DEGRADATION_OF_DVL	Signal Transduction
REACTOME_DISASSEMBLY_OF_THE_DESTRUCTION_COMPLEX_AND_RECRUITMENT_OF_AXIN_TO_THE_MEMBRANE	Signal Transduction
REACTOME_REGULATION_OF_FZD_BY_UBIQUITINATION	Signal Transduction
REACTOME_NEGATIVE_REGULATION_OF_TCF_DEPENDENT_SIGNALING_BY_DVL_INTERACTING_PROTEINS	Signal Transduction
REACTOME_BINDING_OF_TCF_LEF:CTNNB1_TO_TARGET_GENE_PROMOTERS	Signal Transduction
REACTOME_ENOS_ACTIVATION	Metabolism
REACTOME_NOSTRIN_MEDIATED_ENOS_TRAFFICKING	Metabolism
REACTOME_ANCHORING_FIBRIL_FORMATION	Extracellular matrix organization
REACTOME_CROSSLINKING_OF_COLLAGEN_FIBRILS	Extracellular matrix organization
REACTOME_DOWNSTREAM_TCR_SIGNALING	Immune System
REACTOME_PHOSPHORYLATION_OF_CD3_AND_TCR_ZETA_CHAINS	Immune System
REACTOME_TRANSLOCATION_OF_ZAP_70_TO_IMMUNOLOGICAL_SYNAPSE	Immune System
REACTOME_GENERATION_OF_SECOND_MESSENGER_MOLECULES	Immune System
REACTOME_PECAM1_INTERACTIONS	Hemostasis
REACTOME_BASIGIN_INTERACTIONS	Hemostasis
REACTOME_TIE2_SIGNALING	Hemostasis
REACTOME_FCGR_ACTIVATION	Immune System
REACTOME_REGULATION_OF_ACTIN_DYNAMICS_FOR_PHAGOCYTIC_CUP_FORMATION	Immune System
REACTOME_ROLE_OF_PHOSPHOLIPIDS_IN_PHAGOCYTOSIS	Immune System
REACTOME_LINOLEIC_ACID_LA_METABOLISM	Metabolism
REACTOME_NRAGE_SIGNALS_DEATH_THROUGH_JNK	Signal Transduction
REACTOME_NADE_MODULATES_DEATH_SIGNALLING	Signal Transduction
REACTOME_NRIF_SIGNALS_CELL_DEATH_FROM_THE_NUCLEUS	Signal Transduction
REACTOME_SEROTONIN_AND_MELATONIN_BIOSYNTHESIS	Metabolism
REACTOME_THYROXINE_BIOSYNTHESIS	Metabolism
REACTOME_MICRORNA_MIRNA_BIOGENESIS	Gene expression (Transcription)
REACTOME_SMALL_INTERFERING_RNA_SIRNA_BIOGENESIS	Gene expression (Transcription)
REACTOME_POST_TRANSCRIPTIONAL_SILENCING_BY_SMALL_RNAS	Gene expression (Transcription)
REACTOME_TRANSCRIPTIONAL_REGULATION_BY_SMALL_RNAS	Gene expression (Transcription)
REACTOME_PIWI_INTERACTING_RNA_PIRNA_BIOGENESIS	Gene expression (Transcription)
REACTOME_PHASE_II_CONJUGATION_OF_COMPOUNDS	Metabolism
REACTOME_PHASE_I_FUNCTIONALIZATION_OF_COMPOUNDS	Metabolism
REACTOME_AFLATOXIN_ACTIVATION_AND_DETOXIFICATION	Metabolism
REACTOME_VITAMINS	Metabolism
REACTOME_FATTY_ACIDS	Metabolism
REACTOME_MISCELLANEOUS_SUBSTRATES	Metabolism
REACTOME_ENDOGENOUS_STEROLS	Metabolism
REACTOME_EICOSANOIDS	Metabolism
REACTOME_XENOBIOTICS	Metabolism
REACTOME_CYTOCHROME_P450_ARRANGED_BY_SUBSTRATE_TYPE	Metabolism
REACTOME_ETHANOL_OXIDATION	Metabolism
REACTOME_ARYL_HYDROCARBON_RECEPTOR_SIGNALLING	Metabolism
REACTOME_CYP2E1_REACTIONS	Metabolism
REACTOME_PRC2_METHYLATES_HISTONES_AND_DNA	Gene expression (Transcription)
REACTOME_POSITIVE_EPIGENETIC_REGULATION_OF_RRNA_EXPRESSION	Gene expression (Transcription)
REACTOME_NEGATIVE_EPIGENETIC_REGULATION_OF_RRNA_EXPRESSION	Gene expression (Transcription)
REACTOME_DNA_METHYLATION	Gene expression (Transcription)
REACTOME_YAP1_AND_WWTR1_TAZ_STIMULATED_GENE_EXPRESSION	Gene expression (Transcription)
REACTOME_NOTCH_HLH_TRANSCRIPTION_PATHWAY	Gene expression (Transcription)
REACTOME_TRANSCRIPTIONAL_REGULATION_BY_TP53	Gene expression (Transcription)
REACTOME_NUCLEAR_RECEPTOR_TRANSCRIPTION_PATHWAY	Gene expression (Transcription)
REACTOME_TRANSCRIPTIONAL_REGULATION_BY_THE_AP_2_TFAP2_FAMILY_OF_TRANSCRIPTION_FACTORS	Gene expression (Transcription)
REACTOME_TRANSCRIPTIONAL_REGULATION_BY_RUNX3	Gene expression (Transcription)
REACTOME_TRANSCRIPTIONAL_REGULATION_BY_RUNX2	Gene expression (Transcription)
REACTOME_TRANSCRIPTIONAL_REGULATION_BY_RUNX1	Gene expression (Transcription)
REACTOME_TRANSCRIPTIONAL_REGULATION_BY_E2F6	Gene expression (Transcription)
REACTOME_TRANSCRIPTIONAL_REGULATION_BY_MECP2	Gene expression (Transcription)
REACTOME_FOXO_MEDIATED_TRANSCRIPTION	Gene expression (Transcription)
REACTOME_SYNTHESIS_OF_EPOXY_EET_AND_DIHYDROXYEICOSATRIENOIC_ACIDS_DHET	Metabolism
REACTOME_SYNTHESIS_OF_5_EICOSATETRAENOIC_ACIDS	Metabolism
REACTOME_SYNTHESIS_OF_LEUKOTRIENES_LT_AND_EOXINS_EX	Metabolism
REACTOME_SYNTHESIS_OF_12_EICOSATETRAENOIC_ACID_DERIVATIVES	Metabolism
REACTOME_SYNTHESIS_OF_15_EICOSATETRAENOIC_ACID_DERIVATIVES	Metabolism
REACTOME_SYNTHESIS_OF_16_20_HYDROXYEICOSATETRAENOIC_ACIDS_HETE	Metabolism
REACTOME_SYNTHESIS_OF_PROSTAGLANDINS_PG_AND_THROMBOXANES_TX	Metabolism
REACTOME_HYALURONAN_BIOSYNTHESIS_AND_EXPORT	Metabolism
REACTOME_HYALURONAN_UPTAKE_AND_DEGRADATION	Metabolism
REACTOME_ABACAVIR_TRANSMEMBRANE_TRANSPORT	Metabolism
REACTOME_ABACAVIR_METABOLISM	Metabolism
REACTOME_DAP12_SIGNALING	Immune System
REACTOME_SCAVENGING_OF_HEME_FROM_PLASMA	Vesicle-mediated transport
REACTOME_SCAVENGING_BY_CLASS_B_RECEPTORS	Vesicle-mediated transport
REACTOME_SCAVENGING_BY_CLASS_A_RECEPTORS	Vesicle-mediated transport
REACTOME_SCAVENGING_BY_CLASS_F_RECEPTORS	Vesicle-mediated transport
REACTOME_DOWNREGULATION_OF_TGF_BETA_RECEPTOR_SIGNALING	Signal Transduction
REACTOME_DOWNREGULATION_OF_SMAD2_3:SMAD4_TRANSCRIPTIONAL_ACTIVITY	Gene expression (Transcription)
REACTOME_DOWNREGULATION_OF_SMAD2_3:SMAD4_TRANSCRIPTIONAL_ACTIVITY	Signal Transduction
REACTOME_SMAD2_SMAD3:SMAD4_HETEROTRIMER_REGULATES_TRANSCRIPTION	Gene expression (Transcription)
REACTOME_SMAD2_SMAD3:SMAD4_HETEROTRIMER_REGULATES_TRANSCRIPTION	Signal Transduction
REACTOME_THE_RETINOID_CYCLE_IN_CONES_DAYLIGHT_VISION	Signal Transduction
REACTOME_THE_CANONICAL_RETINOID_CYCLE_IN_RODS_TWILIGHT_VISION	Signal Transduction
REACTOME_THE_PHOTOTRANSDUCTION_CASCADE	Signal Transduction
REACTOME_CONSTITUTIVE_SIGNALING_BY_ABERRANT_PI3K_IN_CANCER	Disease
REACTOME_CONSTITUTIVE_SIGNALING_BY_AKT1_E17K_IN_CANCER	Disease
REACTOME_CELLULAR_RESPONSE_TO_HYPOXIA	Cellular responses to external stimuli
REACTOME_CELLULAR_SENESCENCE	Cellular responses to external stimuli
REACTOME_DETOXIFICATION_OF_REACTIVE_OXYGEN_SPECIES	Cellular responses to external stimuli
REACTOME_HSP90_CHAPERONE_CYCLE_FOR_STEROID_HORMONE_RECEPTORS_SHR	Cellular responses to external stimuli
REACTOME_CELLULAR_RESPONSE_TO_HEAT_STRESS	Cellular responses to external stimuli
REACTOME_METABOLISM_OF_INGESTED_SEMET_SEC_MESEC_INTO_H2SE	Metabolism
REACTOME_SHC_RELATED_EVENTS_TRIGGERED_BY_IGF1R	Signal Transduction
REACTOME_IRS_MEDIATED_SIGNALLING	Signal Transduction
REACTOME_ROLE_OF_LAT2_NTAL_LAB_ON_CALCIUM_MOBILIZATION	Immune System
REACTOME_FCERI_MEDIATED_MAPK_ACTIVATION	Immune System
REACTOME_FCERI_MEDIATED_CAPLUS2_MOBILIZATION	Immune System
REACTOME_FCERI_MEDIATED_NF_KB_ACTIVATION	Immune System
REACTOME_ACTIVATION_OF_THE_PHOTOTRANSDUCTION_CASCADE	Signal Transduction
REACTOME_OXIDATIVE_STRESS_INDUCED_SENESCENCE	Cellular responses to external stimuli
REACTOME_SENESCENCE_ASSOCIATED_SECRETORY_PHENOTYPE_SASP	Cellular responses to external stimuli
REACTOME_ONCOGENE_INDUCED_SENESCENCE	Cellular responses to external stimuli
REACTOME_DNA_DAMAGE_TELOMERE_STRESS_INDUCED_SENESCENCE	Cellular responses to external stimuli
REACTOME_FORMATION_OF_SENESCENCE_ASSOCIATED_HETEROCHROMATIN_FOCI_SAHF	Cellular responses to external stimuli
REACTOME_FBXW7_MUTANTS_AND_NOTCH1_IN_CANCER	Disease
REACTOME_SIGNALING_BY_NOTCH1_HD_DOMAIN_MUTANTS_IN_CANCER	Disease
REACTOME_TRP_CHANNELS	Transport of small molecules
REACTOME_EPHB_MEDIATED_FORWARD_SIGNALING	Developmental Biology
REACTOME_EPHA_MEDIATED_GROWTH_CONE_COLLAPSE	Developmental Biology
REACTOME_EPHRIN_SIGNALING	Developmental Biology
REACTOME_EPH_EPHRIN_MEDIATED_REPULSION_OF_CELLS	Developmental Biology
REACTOME_METABOLISM_OF_ANGIOTENSINOGEN_TO_ANGIOTENSINS	Metabolism of proteins
REACTOME_PEPTIDE_HORMONE_BIOSYNTHESIS	Metabolism of proteins
REACTOME_INSULIN_PROCESSING	Metabolism of proteins
REACTOME_INCRETIN_SYNTHESIS_SECRETION_AND_INACTIVATION	Metabolism of proteins
REACTOME_SYNTHESIS_SECRETION_AND_DEACYLATION_OF_GHRELIN	Metabolism of proteins
REACTOME_ACTIVATION_OF_NIMA_KINASES_NEK9_NEK6_NEK7	Cell Cycle
REACTOME_NUCLEAR_PORE_COMPLEX_NPC_DISASSEMBLY	Cell Cycle
REACTOME_DEPOLYMERISATION_OF_THE_NUCLEAR_LAMINA	Cell Cycle
REACTOME_PROCESSING_AND_ACTIVATION_OF_SUMO	Metabolism of proteins
REACTOME_SYNDECAN_INTERACTIONS	Extracellular matrix organization
REACTOME_SUMOYLATION_OF_DNA_DAMAGE_RESPONSE_AND_REPAIR_PROTEINS	Metabolism of proteins
REACTOME_SUMOYLATION_OF_TRANSCRIPTION_FACTORS	Metabolism of proteins
REACTOME_SUMOYLATION_OF_UBIQUITINYLATION_PROTEINS	Metabolism of proteins
REACTOME_SUMOYLATION_OF_TRANSCRIPTION_COFACTORS	Metabolism of proteins
REACTOME_SUMOYLATION_OF_SUMOYLATION_PROTEINS	Metabolism of proteins
REACTOME_SUMOYLATION_OF_INTRACELLULAR_RECEPTORS	Metabolism of proteins
REACTOME_SUMOYLATION_OF_CHROMATIN_ORGANIZATION_PROTEINS	Metabolism of proteins
REACTOME_SUMOYLATION_OF_RNA_BINDING_PROTEINS	Metabolism of proteins
REACTOME_SUMOYLATION_OF_DNA_REPLICATION_PROTEINS	Metabolism of proteins
REACTOME_SUMOYLATION_OF_DNA_METHYLATION_PROTEINS	Metabolism of proteins
REACTOME_SUMOYLATION_OF_IMMUNE_RESPONSE_PROTEINS	Metabolism of proteins
REACTOME_SUMO_IS_CONJUGATED_TO_E1_UBA2:SAE1	Metabolism of proteins
REACTOME_SUMO_IS_TRANSFERRED_FROM_E1_TO_E2_UBE2I_UBC9	Metabolism of proteins
REACTOME_SUMO_IS_PROTEOLYTICALLY_PROCESSED	Metabolism of proteins
REACTOME_MYOCLONIC_EPILEPSY_OF_LAFORA	Disease
REACTOME_HDACS_DEACETYLATE_HISTONES	Chromatin organization
REACTOME_PKMTS_METHYLATE_HISTONE_LYSINES	Chromatin organization
REACTOME_HDMS_DEMETHYLATE_HISTONES	Chromatin organization
REACTOME_HATS_ACETYLATE_HISTONES	Chromatin organization
REACTOME_RMTS_METHYLATE_HISTONE_ARGININES	Chromatin organization
REACTOME_DEFECTS_IN_COBALAMIN_B12_METABOLISM	Disease
REACTOME_DEFECTS_IN_BIOTIN_BTN_METABOLISM	Disease
REACTOME_LOSS_OF_FUNCTION_OF_TGFBR1_IN_CANCER	Disease
REACTOME_REGULATION_OF_HSF1_MEDIATED_HEAT_SHOCK_RESPONSE	Cellular responses to external stimuli
REACTOME_HSF1_ACTIVATION	Cellular responses to external stimuli
REACTOME_HSF1_DEPENDENT_TRANSACTIVATION	Cellular responses to external stimuli
REACTOME_ATTENUATION_PHASE	Cellular responses to external stimuli
REACTOME_GRB2:SOS_PROVIDES_LINKAGE_TO_MAPK_SIGNALING_FOR_INTEGRINS	Hemostasis
REACTOME_GRB2:SOS_PROVIDES_LINKAGE_TO_MAPK_SIGNALING_FOR_INTEGRINS	Signal Transduction
REACTOME_P130CAS_LINKAGE_TO_MAPK_SIGNALING_FOR_INTEGRINS	Hemostasis
REACTOME_P130CAS_LINKAGE_TO_MAPK_SIGNALING_FOR_INTEGRINS	Signal Transduction
REACTOME_DEFECTIVE_B4GALT7_CAUSES_EDS_PROGEROID_TYPE	Disease
REACTOME_DEFECTIVE_CHST3_CAUSES_SEDCJD	Disease
REACTOME_DEFECTIVE_CHST14_CAUSES_EDS_MUSCULOCONTRACTURAL_TYPE	Disease
REACTOME_DEFECTIVE_CHSY1_CAUSES_TPBS	Disease
REACTOME_DEFECTIVE_CHST6_CAUSES_MCDC1	Disease
REACTOME_DEFECTIVE_EXT2_CAUSES_EXOSTOSES_2	Disease
REACTOME_DEFECTIVE_ST3GAL3_CAUSES_MCT12_AND_EIEE15	Disease
REACTOME_DEFECTIVE_B4GALT1_CAUSES_B4GALT1_CDG_CDG_2D	Disease
REACTOME_TP53_REGULATES_METABOLIC_GENES	Gene expression (Transcription)
REACTOME_REGULATION_OF_TP53_ACTIVITY	Gene expression (Transcription)
REACTOME_TP53_REGULATES_TRANSCRIPTION_OF_CELL_DEATH_GENES	Gene expression (Transcription)
REACTOME_TP53_REGULATES_TRANSCRIPTION_OF_CELL_CYCLE_GENES	Gene expression (Transcription)
REACTOME_TP53_REGULATES_TRANSCRIPTION_OF_DNA_REPAIR_GENES	Gene expression (Transcription)
REACTOME_GPCR_LIGAND_BINDING	Signal Transduction
REACTOME_PEPTIDE_LIGAND_BINDING_RECEPTORS	Signal Transduction
REACTOME_AMINE_LIGAND_BINDING_RECEPTORS	Signal Transduction
REACTOME_HORMONE_LIGAND_BINDING_RECEPTORS	Signal Transduction
REACTOME_EICOSANOID_LIGAND_BINDING_RECEPTORS	Signal Transduction
REACTOME_NUCLEOTIDE_LIKE_PURINERGIC_RECEPTORS	Signal Transduction
REACTOME_LYSOSPHINGOLIPID_AND_LPA_RECEPTORS	Signal Transduction
REACTOME_OPSINS	Signal Transduction
REACTOME_FREE_FATTY_ACID_RECEPTORS	Signal Transduction
REACTOME_CALCITONIN_LIKE_LIGAND_RECEPTORS	Signal Transduction
REACTOME_GLUCAGON_TYPE_LIGAND_RECEPTORS	Signal Transduction
REACTOME_DSCAM_INTERACTIONS	Developmental Biology
REACTOME_DCC_MEDIATED_ATTRACTIVE_SIGNALING	Developmental Biology
REACTOME_NETRIN_MEDIATED_REPULSION_SIGNALS	Developmental Biology
REACTOME_ROLE_OF_SECOND_MESSENGERS_IN_NETRIN_1_SIGNALING	Developmental Biology
REACTOME_SEMA3A_PAK_DEPENDENT_AXON_REPULSION	Developmental Biology
REACTOME_SEMA3A_PLEXIN_REPULSION_SIGNALING_BY_INHIBITING_INTEGRIN_ADHESION	Developmental Biology
REACTOME_CRMPS_IN_SEMA3A_SIGNALING	Developmental Biology
REACTOME_SEMA4D_IN_SEMAPHORIN_SIGNALING	Developmental Biology
REACTOME_OTHER_SEMAPHORIN_INTERACTIONS	Developmental Biology
REACTOME_RECYCLING_PATHWAY_OF_L1	Developmental Biology
REACTOME_INTERACTION_BETWEEN_L1_AND_ANKYRINS	Developmental Biology
REACTOME_SIGNAL_TRANSDUCTION_BY_L1	Developmental Biology
REACTOME_NRCAM_INTERACTIONS	Developmental Biology
REACTOME_CHL1_INTERACTIONS	Developmental Biology
REACTOME_NEUROFASCIN_INTERACTIONS	Developmental Biology
REACTOME_NCAM1_INTERACTIONS	Developmental Biology
REACTOME_TACHYKININ_RECEPTORS_BIND_TACHYKININS	Signal Transduction
REACTOME_CHEMOKINE_RECEPTORS_BIND_CHEMOKINES	Signal Transduction
REACTOME_VASOPRESSIN_LIKE_RECEPTORS	Signal Transduction
REACTOME_OREXIN_AND_NEUROPEPTIDES_FF_AND_QRFP_BIND_TO_THEIR_RESPECTIVE_RECEPTORS	Signal Transduction
REACTOME_FORMYL_PEPTIDE_RECEPTORS_BIND_FORMYL_PEPTIDES_AND_MANY_OTHER_LIGANDS	Signal Transduction
REACTOME_RELAXIN_RECEPTORS	Signal Transduction
REACTOME_MUSCARINIC_ACETYLCHOLINE_RECEPTORS	Signal Transduction
REACTOME_DOPAMINE_RECEPTORS	Signal Transduction
REACTOME_SEROTONIN_RECEPTORS	Signal Transduction
REACTOME_ADRENOCEPTORS	Signal Transduction
REACTOME_ACTIVATION_OF_RAC1	Developmental Biology
REACTOME_REGULATION_OF_COMMISSURAL_AXON_PATHFINDING_BY_SLIT_AND_ROBO	Developmental Biology
REACTOME_INACTIVATION_OF_CDC42_AND_RAC1	Developmental Biology
REACTOME_ROLE_OF_ABL_IN_ROBO_SLIT_SIGNALING	Developmental Biology
REACTOME_REGULATION_OF_EXPRESSION_OF_SLITS_AND_ROBOS	Developmental Biology
REACTOME_ROBO_RECEPTORS_BIND_AKAP5	Developmental Biology
REACTOME_DISEASES_ASSOCIATED_WITH_GLYCOSAMINOGLYCAN_METABOLISM	Disease
REACTOME_DISEASES_ASSOCIATED_WITH_N_GLYCOSYLATION_OF_PROTEINS	Disease
REACTOME_DISEASES_ASSOCIATED_WITH_O_GLYCOSYLATION_OF_PROTEINS	Disease
REACTOME_DISEASES_ASSOCIATED_WITH_GLYCOSYLATION_PRECURSOR_BIOSYNTHESIS	Disease
REACTOME_CYTOSOLIC_TRNA_AMINOACYLATION	Metabolism of proteins
REACTOME_MITOCHONDRIAL_TRNA_AMINOACYLATION	Metabolism of proteins
REACTOME_ATF6_ATF6_ALPHA_ACTIVATES_CHAPERONE_GENES	Metabolism of proteins
REACTOME_ATF4_ACTIVATES_GENES_IN_RESPONSE_TO_ENDOPLASMIC_RETICULUM_STRESS	Metabolism of proteins
REACTOME_ATF6_ATF6_ALPHA_ACTIVATES_CHAPERONES	Metabolism of proteins
REACTOME_PERK_REGULATES_GENE_EXPRESSION	Metabolism of proteins
REACTOME_IRE1ALPHA_ACTIVATES_CHAPERONES	Metabolism of proteins
REACTOME_CREB3_FACTORS_ACTIVATE_GENES	Metabolism of proteins
REACTOME_O2_CO2_EXCHANGE_IN_ERYTHROCYTES	Transport of small molecules
REACTOME_PLASMA_LIPOPROTEIN_ASSEMBLY_REMODELING_AND_CLEARANCE	Transport of small molecules
REACTOME_ABC_FAMILY_PROTEINS_MEDIATED_TRANSPORT	Transport of small molecules
REACTOME_SLC_MEDIATED_TRANSMEMBRANE_TRANSPORT	Transport of small molecules
REACTOME_AQUAPORIN_MEDIATED_TRANSPORT	Transport of small molecules
REACTOME_MISCELLANEOUS_TRANSPORT_AND_BINDING_EVENTS	Transport of small molecules
REACTOME_MITOCHONDRIAL_CALCIUM_ION_TRANSPORT	Transport of small molecules
REACTOME_IRON_UPTAKE_AND_TRANSPORT	Transport of small molecules
REACTOME_ION_CHANNEL_TRANSPORT	Transport of small molecules
REACTOME_ABC_TRANSPORTERS_IN_LIPID_HOMEOSTASIS	Transport of small molecules
REACTOME_CA2PLUS_PATHWAY	Signal Transduction
REACTOME_PCP_CE_PATHWAY	Signal Transduction
REACTOME_G_PROTEIN_BETA:GAMMA_SIGNALLING	Signal Transduction
REACTOME_G_ALPHA_Q_SIGNALLING_EVENTS	Signal Transduction
REACTOME_G_ALPHA_12_13_SIGNALLING_EVENTS	Signal Transduction
REACTOME_G_ALPHA_S_SIGNALLING_EVENTS	Signal Transduction
REACTOME_G_ALPHA_I_SIGNALLING_EVENTS	Signal Transduction
REACTOME_G_ALPHA_Z_SIGNALLING_EVENTS	Signal Transduction
REACTOME_CD28_CO_STIMULATION	Immune System
REACTOME_CTLA4_INHIBITORY_SIGNALING	Immune System
REACTOME_PD_1_SIGNALING	Immune System
REACTOME_CD28_DEPENDENT_PI3K_AKT_SIGNALING	Immune System
REACTOME_CD28_DEPENDENT_VAV1_PATHWAY	Immune System
REACTOME_PREFOLDIN_MEDIATED_TRANSFER_OF_SUBSTRATE_TO_CCT_TRIC	Metabolism of proteins
REACTOME_FORMATION_OF_TUBULIN_FOLDING_INTERMEDIATES_BY_CCT_TRIC	Metabolism of proteins
REACTOME_FOLDING_OF_ACTIN_BY_CCT_TRIC	Metabolism of proteins
REACTOME_COOPERATION_OF_PREFOLDIN_AND_TRIC_CCT_IN_ACTIN_AND_TUBULIN_FOLDING	Metabolism of proteins
REACTOME_ASSOCIATION_OF_TRIC_CCT_WITH_TARGET_PROTEINS_DURING_BIOSYNTHESIS	Metabolism of proteins
REACTOME_COOPERATION_OF_PDCL_PHLP1_AND_TRIC_CCT_IN_G_PROTEIN_BETA_FOLDING	Metabolism of proteins
REACTOME_DEFECTIVE_GALNT3_CAUSES_FAMILIAL_HYPERPHOSPHATEMIC_TUMORAL_CALCINOSIS_HFTC	Disease
REACTOME_DEFECTIVE_LFNG_CAUSES_SCDO3	Disease
REACTOME_DEFECTIVE_C1GALT1C1_CAUSES_TN_POLYAGGLUTINATION_SYNDROME_TNPS	Disease
REACTOME_ALPHA_OXIDATION_OF_PHYTANATE	Metabolism
REACTOME_BETA_OXIDATION_OF_PRISTANOYL_COA	Metabolism
REACTOME_BETA_OXIDATION_OF_VERY_LONG_CHAIN_FATTY_ACIDS	Metabolism
REACTOME_POST_CHAPERONIN_TUBULIN_FOLDING_PATHWAY	Metabolism of proteins
REACTOME_LEUKOTRIENE_RECEPTORS	Signal Transduction
REACTOME_PROSTANOID_LIGAND_RECEPTORS	Signal Transduction
REACTOME_CGMP_EFFECTS	Hemostasis
REACTOME_PEPTIDE_HORMONE_METABOLISM	Metabolism of proteins
REACTOME_UNFOLDED_PROTEIN_RESPONSE_UPR	Metabolism of proteins
REACTOME_REGULATION_OF_INSULIN_LIKE_GROWTH_FACTOR_IGF_TRANSPORT_AND_UPTAKE_BY_INSULIN_LIKE_GROWTH_FACTOR_BINDING_PROTEINS_IGFBPS	Metabolism of proteins
REACTOME_PROTEIN_FOLDING	Metabolism of proteins
REACTOME_PROTEIN_REPAIR	Metabolism of proteins
REACTOME_SURFACTANT_METABOLISM	Metabolism of proteins
REACTOME_POST_TRANSLATIONAL_PROTEIN_MODIFICATION	Metabolism of proteins
REACTOME_TRANSLATION	Metabolism of proteins
REACTOME_AMYLOID_FIBER_FORMATION	Metabolism of proteins
REACTOME_ADP_SIGNALLING_THROUGH_P2Y_PURINOCEPTOR_12	Hemostasis
REACTOME_ADP_SIGNALLING_THROUGH_P2Y_PURINOCEPTOR_1	Hemostasis
REACTOME_THROMBOXANE_SIGNALLING_THROUGH_TP_RECEPTOR	Hemostasis
REACTOME_STRIATED_MUSCLE_CONTRACTION	Muscle contraction
REACTOME_SMOOTH_MUSCLE_CONTRACTION	Muscle contraction
REACTOME_CARDIAC_CONDUCTION	Muscle contraction
REACTOME_G_BETA:GAMMA_SIGNALLING_THROUGH_PI3KGAMMA	Signal Transduction
REACTOME_G_BETA:GAMMA_SIGNALLING_THROUGH_CDC42	Signal Transduction
REACTOME_TRAFFICKING_OF_GLUR2_CONTAINING_AMPA_RECEPTORS	Neuronal System
REACTOME_RORA_ACTIVATES_GENE_EXPRESSION	Circadian Clock
REACTOME_BMAL1:CLOCK_NPAS2_ACTIVATES_CIRCADIAN_GENE_EXPRESSION	Circadian Clock
REACTOME_FATTY_ACIDS_BOUND_TO_GPR40_FFAR1_REGULATE_INSULIN_SECRETION	Metabolism
REACTOME_SYNTHESIS_SECRETION_AND_INACTIVATION_OF_GLUCOSE_DEPENDENT_INSULINOTROPIC_POLYPEPTIDE_GIP	Metabolism of proteins
REACTOME_SEMA4D_MEDIATED_INHIBITION_OF_CELL_ATTACHMENT_AND_MIGRATION	Developmental Biology
REACTOME_SEMA4D_INDUCED_CELL_MIGRATION_AND_GROWTH_CONE_COLLAPSE	Developmental Biology
REACTOME_ASYMMETRIC_LOCALIZATION_OF_PCP_PROTEINS	Signal Transduction
REACTOME_WNT5A_DEPENDENT_INTERNALIZATION_OF_FZD4	Signal Transduction
REACTOME_WNT5A_DEPENDENT_INTERNALIZATION_OF_FZD2_FZD5_AND_ROR2	Signal Transduction
REACTOME_EFFECTS_OF_PIP2_HYDROLYSIS	Hemostasis
REACTOME_EFFECTS_OF_PIP2_HYDROLYSIS	Signal Transduction
REACTOME_GASTRIN_CREB_SIGNALLING_PATHWAY_VIA_PKC_AND_MAPK	Signal Transduction
REACTOME_P2Y_RECEPTORS	Signal Transduction
REACTOME_NITRIC_OXIDE_STIMULATES_GUANYLATE_CYCLASE	Hemostasis
REACTOME_PROSTACYCLIN_SIGNALLING_THROUGH_PROSTACYCLIN_RECEPTOR	Hemostasis
REACTOME_PLATELET_CALCIUM_HOMEOSTASIS	Hemostasis
REACTOME_PLATELET_SENSITIZATION_BY_LDL	Hemostasis
REACTOME_ELEVATION_OF_CYTOSOLIC_CA2PLUS_LEVELS	Hemostasis
REACTOME_REDUCTION_OF_CYTOSOLIC_CAPLUSPLUS_LEVELS	Hemostasis
REACTOME_OLFACTORY_SIGNALING_PATHWAY	Signal Transduction
REACTOME_OPIOID_SIGNALLING	Signal Transduction
REACTOME_VISUAL_PHOTOTRANSDUCTION	Signal Transduction
REACTOME_NECTIN_NECL_TRANS_HETERODIMERIZATION	Cell-Cell communication
REACTOME_ADHERENS_JUNCTIONS_INTERACTIONS	Cell-Cell communication
REACTOME_TIGHT_JUNCTION_INTERACTIONS	Cell-Cell communication
REACTOME_GLUCAGON_LIKE_PEPTIDE_1_GLP1_REGULATES_INSULIN_SECRETION	Metabolism
REACTOME_ACETYLCHOLINE_REGULATES_INSULIN_SECRETION	Metabolism
REACTOME_ADRENALINE_NORADRENALINE_INHIBITS_INSULIN_SECRETION	Metabolism
REACTOME_FREE_FATTY_ACIDS_REGULATE_INSULIN_SECRETION	Metabolism
REACTOME_EPH_EPHRIN_SIGNALING	Developmental Biology
REACTOME_NETRIN_1_SIGNALING	Developmental Biology
REACTOME_SEMAPHORIN_INTERACTIONS	Developmental Biology
REACTOME_L1CAM_INTERACTIONS	Developmental Biology
REACTOME_NCAM_SIGNALING_FOR_NEURITE_OUT_GROWTH	Developmental Biology
REACTOME_SIGNALING_BY_ROBO_RECEPTORS	Developmental Biology
REACTOME_RET_SIGNALING	Developmental Biology
REACTOME_REELIN_SIGNALLING_PATHWAY	Developmental Biology
REACTOME_METAL_ION_SLC_TRANSPORTERS	Transport of small molecules
REACTOME_SODIUM_COUPLED_SULPHATE_DI_AND_TRI_CARBOXYLATE_TRANSPORTERS	Transport of small molecules
REACTOME_PROTON_COUPLED_MONOCARBOXYLATE_TRANSPORT	Transport of small molecules
REACTOME_NAPLUS_CL_DEPENDENT_NEUROTRANSMITTER_TRANSPORTERS	Transport of small molecules
REACTOME_ORGANIC_CATION_ANION_ZWITTERION_TRANSPORT	Transport of small molecules
REACTOME_AMINO_ACID_TRANSPORT_ACROSS_THE_PLASMA_MEMBRANE	Transport of small molecules
REACTOME_BICARBONATE_TRANSPORTERS	Transport of small molecules
REACTOME_SODIUM_CALCIUM_EXCHANGERS	Transport of small molecules
REACTOME_SODIUM_PROTON_EXCHANGERS	Transport of small molecules
REACTOME_CATION_COUPLED_CHLORIDE_COTRANSPORTERS	Transport of small molecules
REACTOME_MULTIFUNCTIONAL_ANION_EXCHANGERS	Transport of small molecules
REACTOME_SODIUM_COUPLED_PHOSPHATE_COTRANSPORTERS	Transport of small molecules
REACTOME_ORGANIC_ANION_TRANSPORTERS	Transport of small molecules
REACTOME_TRANSPORT_OF_NUCLEOTIDE_SUGARS	Transport of small molecules
REACTOME_TRANSPORT_OF_FATTY_ACIDS	Transport of small molecules
REACTOME_TRANSPORT_OF_NUCLEOSIDES_AND_FREE_PURINE_AND_PYRIMIDINE_BASES_ACROSS_THE_PLASMA_MEMBRANE	Transport of small molecules
REACTOME_TRANSPORT_OF_ORGANIC_ANIONS	Transport of small molecules
REACTOME_CELLULAR_HEXOSE_TRANSPORT	Transport of small molecules
REACTOME_TRANSPORT_OF_BILE_SALTS_AND_ORGANIC_ACIDS_METAL_IONS_AND_AMINE_COMPOUNDS	Transport of small molecules
REACTOME_TRANSPORT_OF_INORGANIC_CATIONS_ANIONS_AND_AMINO_ACIDS_OLIGOPEPTIDES	Transport of small molecules
REACTOME_TRANSPORT_OF_VITAMINS_NUCLEOSIDES_AND_RELATED_MOLECULES	Transport of small molecules
REACTOME_ZINC_TRANSPORTERS	Transport of small molecules
REACTOME_SPHINGOLIPID_DE_NOVO_BIOSYNTHESIS	Metabolism
REACTOME_GLYCOSPHINGOLIPID_METABOLISM	Metabolism
REACTOME_DEADENYLATION_OF_MRNA	Metabolism of RNA
REACTOME_MRNA_DECAY_BY_3_TO_5_EXORIBONUCLEASE	Metabolism of RNA
REACTOME_MRNA_DECAY_BY_5_TO_3_EXORIBONUCLEASE	Metabolism of RNA
REACTOME_ZINC_EFFLUX_AND_COMPARTMENTALIZATION_BY_THE_SLC30_FAMILY	Transport of small molecules
REACTOME_ZINC_INFLUX_INTO_CELLS_BY_THE_SLC39_GENE_FAMILY	Transport of small molecules
REACTOME_CREB1_PHOSPHORYLATION_THROUGH_THE_ACTIVATION_OF_ADENYLATE_CYCLASE	Neuronal System
REACTOME_CREB1_PHOSPHORYLATION_THROUGH_THE_ACTIVATION_OF_CAMKII_CAMKK_CAMKIV_CASCASDE	Neuronal System
REACTOME_CREB1_PHOSPHORYLATION_THROUGH_NMDA_RECEPTOR_MEDIATED_ACTIVATION_OF_RAS_SIGNALING	Neuronal System
REACTOME_ACTIVATION_OF_RAC1_DOWNSTREAM_OF_NMDARS	Neuronal System
REACTOME_ACTIVATION_OF_AMPK_DOWNSTREAM_OF_NMDARS	Neuronal System
REACTOME_LONG_TERM_POTENTIATION	Neuronal System
REACTOME_VEGFR2_MEDIATED_VASCULAR_PERMEABILITY	Signal Transduction
REACTOME_VEGFR2_MEDIATED_CELL_PROLIFERATION	Signal Transduction
REACTOME_RAS_ACTIVATION_UPON_CA2PLUS_INFLUX_THROUGH_NMDA_RECEPTOR	Neuronal System
REACTOME_RSK_ACTIVATION	Neuronal System
REACTOME_UNBLOCKING_OF_NMDA_RECEPTORS_GLUTAMATE_BINDING_AND_ACTIVATION	Neuronal System
REACTOME_ASSEMBLY_AND_CELL_SURFACE_PRESENTATION_OF_NMDA_RECEPTORS	Neuronal System
REACTOME_NEGATIVE_REGULATION_OF_NMDA_RECEPTOR_MEDIATED_NEURONAL_TRANSMISSION	Neuronal System
REACTOME_VASOPRESSIN_REGULATES_RENAL_WATER_HOMEOSTASIS_VIA_AQUAPORINS	Transport of small molecules
REACTOME_PASSIVE_TRANSPORT_BY_AQUAPORINS	Transport of small molecules
REACTOME_SYNTHESIS_OF_SUBSTRATES_IN_N_GLYCAN_BIOSYTHESIS	Metabolism of proteins
REACTOME_BIOSYNTHESIS_OF_THE_N_GLYCAN_PRECURSOR_DOLICHOL_LIPID_LINKED_OLIGOSACCHARIDE_LLO_AND_TRANSFER_TO_A_NASCENT_PROTEIN	Metabolism of proteins
REACTOME_N_GLYCAN_TRIMMING_IN_THE_ER_AND_CALNEXIN_CALRETICULIN_CYCLE	Metabolism of proteins
REACTOME_TRANSPORT_TO_THE_GOLGI_AND_SUBSEQUENT_MODIFICATION	Metabolism of proteins
REACTOME_SIALIC_ACID_METABOLISM	Metabolism of proteins
REACTOME_SYNTHESIS_OF_DOLICHYL_PHOSPHATE	Metabolism of proteins
REACTOME_SYNTHESIS_OF_GDP_MANNOSE	Metabolism of proteins
REACTOME_SYNTHESIS_OF_UDP_N_ACETYL_GLUCOSAMINE	Metabolism of proteins
REACTOME_GDP_FUCOSE_BIOSYNTHESIS	Metabolism of proteins
REACTOME_REGULATION_OF_CYTOSKELETAL_REMODELING_AND_CELL_SPREADING_BY_IPP_COMPLEX_COMPONENTS	Cell-Cell communication
REACTOME_INTERLEUKIN_1_PROCESSING	Immune System
REACTOME_INTERLEUKIN_37_SIGNALING	Immune System
REACTOME_INTERLEUKIN_18_SIGNALING	Immune System
REACTOME_INTERLEUKIN_36_PATHWAY	Immune System
REACTOME_INTERLEUKIN_1_SIGNALING	Immune System
REACTOME_CELL_CELL_JUNCTION_ORGANIZATION	Cell-Cell communication
REACTOME_TYPE_I_HEMIDESMOSOME_ASSEMBLY	Cell-Cell communication
REACTOME_CELL_EXTRACELLULAR_MATRIX_INTERACTIONS	Cell-Cell communication
REACTOME_INTERLEUKIN_35_SIGNALLING	Immune System
REACTOME_INTERLEUKIN_12_SIGNALING	Immune System
REACTOME_INTERLEUKIN_23_SIGNALING	Immune System
REACTOME_INTERLEUKIN_27_SIGNALING	Immune System
REACTOME_INTERLEUKIN_7_SIGNALING	Immune System
REACTOME_INTERLEUKIN_1_FAMILY_SIGNALING	Immune System
REACTOME_INTERLEUKIN_12_FAMILY_SIGNALING	Immune System
REACTOME_INTERLEUKIN_17_SIGNALING	Immune System
REACTOME_OTHER_INTERLEUKIN_SIGNALING	Immune System
REACTOME_INTERLEUKIN_2_FAMILY_SIGNALING	Immune System
REACTOME_INTERLEUKIN_3_INTERLEUKIN_5_AND_GM_CSF_SIGNALING	Immune System
REACTOME_INTERLEUKIN_6_FAMILY_SIGNALING	Immune System
REACTOME_INTERLEUKIN_10_SIGNALING	Immune System
REACTOME_INTERLEUKIN_4_AND_INTERLEUKIN_13_SIGNALING	Immune System
REACTOME_INTERLEUKIN_20_FAMILY_SIGNALING	Immune System
REACTOME_ACTIVATION_OF_THE_AP_1_FAMILY_OF_TRANSCRIPTION_FACTORS	Immune System
REACTOME_MAPK_TARGETS_NUCLEAR_EVENTS_MEDIATED_BY_MAP_KINASES	Immune System
REACTOME_ACTIVATED_TAK1_MEDIATES_P38_MAPK_ACTIVATION	Immune System
REACTOME_JNK_C_JUN_KINASES_PHOSPHORYLATION_AND_ACTIVATION_MEDIATED_BY_ACTIVATED_HUMAN_TAK1	Immune System
REACTOME_MAP3K8_TPL2_DEPENDENT_MAPK1_3_ACTIVATION	Immune System
REACTOME_BUTYRATE_RESPONSE_FACTOR_1_BRF1_BINDS_AND_DESTABILIZES_MRNA	Metabolism of RNA
REACTOME_AUF1_HNRNP_D0_BINDS_AND_DESTABILIZES_MRNA	Metabolism of RNA
REACTOME_TRISTETRAPROLIN_TTP_ZFP36_BINDS_AND_DESTABILIZES_MRNA	Metabolism of RNA
REACTOME_HUR_ELAVL1_BINDS_AND_STABILIZES_MRNA	Metabolism of RNA
REACTOME_KSRP_KHSRP_BINDS_AND_DESTABILIZES_MRNA	Metabolism of RNA
REACTOME_IONOTROPIC_ACTIVITY_OF_KAINATE_RECEPTORS	Neuronal System
REACTOME_PRESYNAPTIC_FUNCTION_OF_KAINATE_RECEPTORS	Neuronal System
REACTOME_INTERLEUKIN_15_SIGNALING	Immune System
REACTOME_INTERLEUKIN_9_SIGNALING	Immune System
REACTOME_INTERLEUKIN_2_SIGNALING	Immune System
REACTOME_INTERLEUKIN_21_SIGNALING	Immune System
REACTOME_INTERLEUKIN_RECEPTOR_SHC_SIGNALING	Immune System
REACTOME_POU5F1_OCT4_SOX2_NANOG_REPRESS_GENES_RELATED_TO_DIFFERENTIATION	Developmental Biology
REACTOME_POU5F1_OCT4_SOX2_NANOG_ACTIVATE_GENES_RELATED_TO_PROLIFERATION	Developmental Biology
REACTOME_G2_PHASE	Cell Cycle
REACTOME_G0_AND_EARLY_G1	Cell Cycle
REACTOME_G1_PHASE	Cell Cycle
REACTOME_PHOSPHORYLATION_SITE_MUTANTS_OF_CTNNB1_ARE_NOT_TARGETED_TO_THE_PROTEASOME_BY_THE_DESTRUCTION_COMPLEX	Disease
REACTOME_MISSPLICED_LRP5_MUTANTS_HAVE_ENHANCED_BETA_CATENIN_DEPENDENT_SIGNALING	Disease
REACTOME_RNF_MUTANTS_SHOW_ENHANCED_WNT_SIGNALING_AND_PROLIFERATION	Disease
REACTOME_CLASS_A_1_RHODOPSIN_LIKE_RECEPTORS	Signal Transduction
REACTOME_CLASS_B_2_SECRETIN_FAMILY_RECEPTORS	Signal Transduction
REACTOME_CLASS_C_3_METABOTROPIC_GLUTAMATE_PHEROMONE_RECEPTORS	Signal Transduction
REACTOME_REGULATION_OF_SIGNALING_BY_CBL	Immune System
REACTOME_O_GLYCOSYLATION_OF_TSR_DOMAIN_CONTAINING_PROTEINS	Metabolism of proteins
REACTOME_O_LINKED_GLYCOSYLATION_OF_MUCINS	Metabolism of proteins
REACTOME_PINK_PARKIN_MEDIATED_MITOPHAGY	Autophagy
REACTOME_RECEPTOR_MEDIATED_MITOPHAGY	Autophagy
REACTOME_ERCC6_CSB_AND_EHMT2_G9A_POSITIVELY_REGULATE_RRNA_EXPRESSION	Gene expression (Transcription)
REACTOME_SIRT1_NEGATIVELY_REGULATES_RRNA_EXPRESSION	Gene expression (Transcription)
REACTOME_CALNEXIN_CALRETICULIN_CYCLE	Metabolism of proteins
REACTOME_NEUROTOXICITY_OF_CLOSTRIDIUM_TOXINS	Disease
REACTOME_UPTAKE_AND_FUNCTION_OF_ANTHRAX_TOXINS	Disease
REACTOME_UPTAKE_AND_FUNCTION_OF_DIPHTHERIA_TOXIN	Disease
REACTOME_CASPASE_ACTIVATION_VIA_DEATH_RECEPTORS_IN_THE_PRESENCE_OF_LIGAND	Programmed Cell Death
REACTOME_CASPASE_ACTIVATION_VIA_DEPENDENCE_RECEPTORS_IN_THE_ABSENCE_OF_LIGAND	Programmed Cell Death
REACTOME_REGULATED_NECROSIS	Programmed Cell Death
REACTOME_RELEASE_OF_HH_NP_FROM_THE_SECRETING_CELL	Signal Transduction
REACTOME_HEDGEHOG_LIGAND_BIOGENESIS	Signal Transduction
REACTOME_HEDGEHOG_OFF_STATE	Signal Transduction
REACTOME_HEDGEHOG_ON_STATE	Signal Transduction
REACTOME_RA_BIOSYNTHESIS_PATHWAY	Signal Transduction
REACTOME_ORGANIC_CATION_TRANSPORT	Transport of small molecules
REACTOME_ORGANIC_ANION_TRANSPORT	Transport of small molecules
REACTOME_PHOSPHOLIPID_METABOLISM	Metabolism
REACTOME_SPHINGOLIPID_METABOLISM	Metabolism
REACTOME_KETONE_BODY_METABOLISM	Metabolism
REACTOME_WAX_AND_PLASMALOGEN_BIOSYNTHESIS	Metabolism
REACTOME_METABOLISM_OF_STEROIDS	Metabolism
REACTOME_LIPID_PARTICLE_ORGANIZATION	Metabolism
REACTOME_FATTY_ACID_METABOLISM	Metabolism
REACTOME_TRIGLYCERIDE_METABOLISM	Metabolism
REACTOME_BIOSYNTHESIS_OF_SPECIALIZED_PRORESOLVING_MEDIATORS_SPMS	Metabolism
REACTOME_PHASE_4_RESTING_MEMBRANE_POTENTIAL	Muscle contraction
REACTOME_PHASE_3_RAPID_REPOLARISATION	Muscle contraction
REACTOME_PHASE_0_RAPID_DEPOLARISATION	Muscle contraction
REACTOME_PHASE_2_PLATEAU_PHASE	Muscle contraction
REACTOME_PHASE_1_INACTIVATION_OF_FAST_NAPLUS_CHANNELS	Muscle contraction
REACTOME_PHYSIOLOGICAL_FACTORS	Muscle contraction
REACTOME_ION_HOMEOSTASIS	Muscle contraction
REACTOME_IKBA_VARIANT_LEADS_TO_EDA_ID	Disease
REACTOME_IRAK4_DEFICIENCY_TLR2_4	Disease
REACTOME_DECTIN_1_MEDIATED_NONCANONICAL_NF_KB_SIGNALING	Immune System
REACTOME_CLEC7A_DECTIN_1_INDUCES_NFAT_ACTIVATION	Immune System
REACTOME_CLEC7A_INFLAMMASOME_PATHWAY	Immune System
REACTOME_DEGRADATION_OF_GLI1_BY_THE_PROTEASOME	Signal Transduction
REACTOME_ANCHORING_OF_THE_BASAL_BODY_TO_THE_PLASMA_MEMBRANE	Organelle biogenesis and maintenance
REACTOME_CARGO_TRAFFICKING_TO_THE_PERICILIARY_MEMBRANE	Organelle biogenesis and maintenance
REACTOME_INTRAFLAGELLAR_TRANSPORT	Organelle biogenesis and maintenance
REACTOME_DEFECTIVE_CFTR_CAUSES_CYSTIC_FIBROSIS	Disease
REACTOME_DEFECTIVE_TPR_MAY_CONFER_SUSCEPTIBILITY_TOWARDS_THYROID_PAPILLARY_CARCINOMA_TPC	Disease
REACTOME_ABC_TRANSPORTER_DISORDERS	Disease
REACTOME_SLC_TRANSPORTER_DISORDERS	Disease
REACTOME_VXPX_CARGO_TARGETING_TO_CILIUM	Organelle biogenesis and maintenance
REACTOME_BBSOME_MEDIATED_CARGO_TARGETING_TO_CILIUM	Organelle biogenesis and maintenance
REACTOME_TRAFFICKING_OF_MYRISTOYLATED_PROTEINS_TO_THE_CILIUM	Organelle biogenesis and maintenance
REACTOME_CLEC7A_DECTIN_1_SIGNALING	Immune System
REACTOME_DECTIN_2_FAMILY	Immune System
REACTOME_CD209_DC_SIGN_SIGNALING	Immune System
REACTOME_ACTIVATED_PKN1_STIMULATES_TRANSCRIPTION_OF_AR_ANDROGEN_RECEPTOR_REGULATED_GENES_KLK2_AND_KLK3	Signal Transduction
REACTOME_LIGAND_RECEPTOR_INTERACTIONS	Signal Transduction
REACTOME_ACTIVATION_OF_SMO	Signal Transduction
REACTOME_GLI_PROTEINS_BIND_PROMOTERS_OF_HH_RESPONSIVE_GENES_TO_PROMOTE_TRANSCRIPTION	Signal Transduction
REACTOME_REGULATION_OF_TP53_ACTIVITY_THROUGH_PHOSPHORYLATION	Gene expression (Transcription)
REACTOME_REGULATION_OF_TP53_ACTIVITY_THROUGH_ACETYLATION	Gene expression (Transcription)
REACTOME_REGULATION_OF_TP53_ACTIVITY_THROUGH_ASSOCIATION_WITH_CO_FACTORS	Gene expression (Transcription)
REACTOME_REGULATION_OF_TP53_ACTIVITY_THROUGH_METHYLATION	Gene expression (Transcription)
REACTOME_REGULATION_OF_TP53_EXPRESSION_AND_DEGRADATION	Gene expression (Transcription)
REACTOME_TP53_REGULATES_TRANSCRIPTION_OF_GENES_INVOLVED_IN_CYTOCHROME_C_RELEASE	Gene expression (Transcription)
REACTOME_TP53_REGULATES_TRANSCRIPTION_OF_SEVERAL_ADDITIONAL_CELL_DEATH_GENES_WHOSE_SPECIFIC_ROLES_IN_P53_DEPENDENT_APOPTOSIS_REMAIN_UNCERTAIN	Gene expression (Transcription)
REACTOME_TP53_REGULATES_TRANSCRIPTION_OF_CASPASE_ACTIVATORS_AND_CASPASES	Gene expression (Transcription)
REACTOME_TP53_REGULATES_TRANSCRIPTION_OF_DEATH_RECEPTORS_AND_LIGANDS	Gene expression (Transcription)
REACTOME_FRUCTOSE_CATABOLISM	Metabolism
REACTOME_BINDING_AND_UPTAKE_OF_LIGANDS_BY_SCAVENGER_RECEPTORS	Vesicle-mediated transport
REACTOME_SHC_MEDIATED_CASCADE:FGFR1	Signal Transduction
REACTOME_PI_3K_CASCADE:FGFR1	Signal Transduction
REACTOME_FRS_MEDIATED_FGFR1_SIGNALING	Signal Transduction
REACTOME_PI_3K_CASCADE:FGFR2	Signal Transduction
REACTOME_SHC_MEDIATED_CASCADE:FGFR2	Signal Transduction
REACTOME_FRS_MEDIATED_FGFR2_SIGNALING	Signal Transduction
REACTOME_SHC_MEDIATED_CASCADE:FGFR3	Signal Transduction
REACTOME_FRS_MEDIATED_FGFR3_SIGNALING	Signal Transduction
REACTOME_PI_3K_CASCADE:FGFR3	Signal Transduction
REACTOME_FRS_MEDIATED_FGFR4_SIGNALING	Signal Transduction
REACTOME_SHC_MEDIATED_CASCADE:FGFR4	Signal Transduction
REACTOME_PI_3K_CASCADE:FGFR4	Signal Transduction
REACTOME_SPRY_REGULATION_OF_FGF_SIGNALING	Signal Transduction
REACTOME_FGFR1_LIGAND_BINDING_AND_ACTIVATION	Signal Transduction
REACTOME_DOWNSTREAM_SIGNALING_OF_ACTIVATED_FGFR1	Signal Transduction
REACTOME_NEGATIVE_REGULATION_OF_FGFR1_SIGNALING	Signal Transduction
REACTOME_FGFRL1_MODULATION_OF_FGFR1_SIGNALING	Signal Transduction
REACTOME_FGFR2_LIGAND_BINDING_AND_ACTIVATION	Signal Transduction
REACTOME_DOWNSTREAM_SIGNALING_OF_ACTIVATED_FGFR2	Signal Transduction
REACTOME_NEGATIVE_REGULATION_OF_FGFR2_SIGNALING	Signal Transduction
REACTOME_FGFR2_ALTERNATIVE_SPLICING	Signal Transduction
REACTOME_FGFR3_LIGAND_BINDING_AND_ACTIVATION	Signal Transduction
REACTOME_DOWNSTREAM_SIGNALING_OF_ACTIVATED_FGFR3	Signal Transduction
REACTOME_NEGATIVE_REGULATION_OF_FGFR3_SIGNALING	Signal Transduction
REACTOME_DOWNSTREAM_SIGNALING_OF_ACTIVATED_FGFR4	Signal Transduction
REACTOME_NEGATIVE_REGULATION_OF_FGFR4_SIGNALING	Signal Transduction
REACTOME_FGFR2_MUTANT_RECEPTOR_ACTIVATION	Disease
REACTOME_FGFR1_MUTANT_RECEPTOR_ACTIVATION	Disease
REACTOME_SIGNALING_BY_FGFR3_FUSIONS_IN_CANCER	Disease
REACTOME_METALLOTHIONEINS_BIND_METALS	Cellular responses to external stimuli
REACTOME_MUCOPOLYSACCHARIDOSES	Disease
REACTOME_GLYCOGEN_STORAGE_DISEASES	Disease
REACTOME_SIGNALING_BY_FGFR_IN_DISEASE	Disease
REACTOME_SIGNALING_BY_EGFR_IN_CANCER	Disease
REACTOME_PI3K_AKT_SIGNALING_IN_CANCER	Disease
REACTOME_DISEASES_ASSOCIATED_WITH_VISUAL_TRANSDUCTION	Disease
REACTOME_SIGNALING_BY_NOTCH1_IN_CANCER	Disease
REACTOME_SIGNALING_BY_TGF_BETA_RECEPTOR_COMPLEX_IN_CANCER	Disease
REACTOME_SIGNALING_BY_WNT_IN_CANCER	Disease
REACTOME_ONCOGENIC_MAPK_SIGNALING	Disease
REACTOME_HIV_INFECTION	Disease
REACTOME_INFLUENZA_INFECTION	Disease
REACTOME_UPTAKE_AND_ACTIONS_OF_BACTERIAL_TOXINS	Disease
REACTOME_LISTERIA_MONOCYTOGENES_ENTRY_INTO_HOST_CELLS	Disease
REACTOME_TNFS_BIND_THEIR_PHYSIOLOGICAL_RECEPTORS	Immune System
REACTOME_TNF_RECEPTOR_SUPERFAMILY_TNFSF_MEMBERS_MEDIATING_NON_CANONICAL_NF_KB_PATHWAY	Immune System
REACTOME_DEFECTS_IN_VITAMIN_AND_COFACTOR_METABOLISM	Disease
REACTOME_METABOLIC_DISORDERS_OF_BIOLOGICAL_OXIDATION_ENZYMES	Disease
REACTOME_DISEASES_OF_CARBOHYDRATE_METABOLISM	Disease
REACTOME_DISEASES_ASSOCIATED_WITH_SURFACTANT_METABOLISM	Disease
REACTOME_REGULATION_OF_RAS_BY_GAPS	Immune System
REACTOME_REGULATION_OF_RAS_BY_GAPS	Signal Transduction
REACTOME_RAF_ACTIVATION	Immune System
REACTOME_RAF_ACTIVATION	Signal Transduction
REACTOME_MAP2K_AND_MAPK_ACTIVATION	Immune System
REACTOME_MAP2K_AND_MAPK_ACTIVATION	Signal Transduction
REACTOME_NEGATIVE_REGULATION_OF_MAPK_PATHWAY	Immune System
REACTOME_NEGATIVE_REGULATION_OF_MAPK_PATHWAY	Signal Transduction
REACTOME_NEGATIVE_FEEDBACK_REGULATION_OF_MAPK_PATHWAY	Immune System
REACTOME_NEGATIVE_FEEDBACK_REGULATION_OF_MAPK_PATHWAY	Signal Transduction
REACTOME_MAPK6_MAPK4_SIGNALING	Signal Transduction
REACTOME_RAF_INDEPENDENT_MAPK1_3_ACTIVATION	Signal Transduction
REACTOME_RESOLUTION_OF_D_LOOP_STRUCTURES	DNA Repair
REACTOME_HOMOLOGOUS_DNA_PAIRING_AND_STRAND_EXCHANGE	DNA Repair
REACTOME_DEFECTIVE_CSF2RB_CAUSES_PULMONARY_SURFACTANT_METABOLISM_DYSFUNCTION_5_SMDP5	Disease
REACTOME_UCH_PROTEINASES	Metabolism of proteins
REACTOME_JOSEPHIN_DOMAIN_DUBS	Metabolism of proteins
REACTOME_UB_SPECIFIC_PROCESSING_PROTEASES	Metabolism of proteins
REACTOME_OVARIAN_TUMOR_DOMAIN_PROTEASES	Metabolism of proteins
REACTOME_METALLOPROTEASE_DUBS	Metabolism of proteins
REACTOME_HOMOLOGY_DIRECTED_REPAIR	DNA Repair
REACTOME_NONHOMOLOGOUS_END_JOINING_NHEJ	DNA Repair
REACTOME_DNA_DOUBLE_STRAND_BREAK_RESPONSE	DNA Repair
REACTOME_RESOLUTION_OF_D_LOOP_STRUCTURES_THROUGH_SYNTHESIS_DEPENDENT_STRAND_ANNEALING_SDSA	DNA Repair
REACTOME_HDR_THROUGH_MMEJ_ALT_NHEJ	DNA Repair
REACTOME_HDR_THROUGH_SINGLE_STRAND_ANNEALING_SSA	DNA Repair
REACTOME_HDR_THROUGH_HOMOLOGOUS_RECOMBINATION_HRR	DNA Repair
REACTOME_PROCESSING_OF_DNA_DOUBLE_STRAND_BREAK_ENDS	DNA Repair
REACTOME_SENSING_OF_DNA_DOUBLE_STRAND_BREAKS	DNA Repair
REACTOME_GLOBAL_GENOME_NUCLEOTIDE_EXCISION_REPAIR_GG_NER	DNA Repair
REACTOME_TRANSCRIPTION_COUPLED_NUCLEOTIDE_EXCISION_REPAIR_TC_NER	DNA Repair
REACTOME_DNA_DAMAGE_RECOGNITION_IN_GG_NER	DNA Repair
REACTOME_FORMATION_OF_INCISION_COMPLEX_IN_GG_NER	DNA Repair
REACTOME_GAP_FILLING_DNA_REPAIR_SYNTHESIS_AND_LIGATION_IN_GG_NER	DNA Repair
REACTOME_DUAL_INCISION_IN_GG_NER	DNA Repair
REACTOME_POST_TRANSLATIONAL_MODIFICATION:_SYNTHESIS_OF_GPI_ANCHORED_PROTEINS	Metabolism of proteins
REACTOME_GAMMA_CARBOXYLATION_HYPUSINE_FORMATION_AND_ARYLSULFATASE_ACTIVATION	Metabolism of proteins
REACTOME_SUMOYLATION	Metabolism of proteins
REACTOME_ASPARAGINE_N_LINKED_GLYCOSYLATION	Metabolism of proteins
REACTOME_O_LINKED_GLYCOSYLATION	Metabolism of proteins
REACTOME_DEUBIQUITINATION	Metabolism of proteins
REACTOME_PROTEIN_UBIQUITINATION	Metabolism of proteins
REACTOME_RAB_GERANYLGERANYLATION	Metabolism of proteins
REACTOME_PROTEIN_METHYLATION	Metabolism of proteins
REACTOME_NEDDYLATION	Metabolism of proteins
REACTOME_CARBOXYTERMINAL_POST_TRANSLATIONAL_MODIFICATIONS_OF_TUBULIN	Metabolism of proteins
REACTOME_COMPLEX_I_BIOGENESIS	Metabolism
REACTOME_THE_NLRP3_INFLAMMASOME	Immune System
REACTOME_HIGHLY_SODIUM_PERMEABLE_ACETYLCHOLINE_NICOTINIC_RECEPTORS	Neuronal System
REACTOME_HIGHLY_CALCIUM_PERMEABLE_NICOTINIC_ACETYLCHOLINE_RECEPTORS	Neuronal System
REACTOME_HIGHLY_CALCIUM_PERMEABLE_POSTSYNAPTIC_NICOTINIC_ACETYLCHOLINE_RECEPTORS	Neuronal System
REACTOME_FORMATION_OF_TC_NER_PRE_INCISION_COMPLEX	DNA Repair
REACTOME_DUAL_INCISION_IN_TC_NER	DNA Repair
REACTOME_SYNTHESIS_OF_WYBUTOSINE_AT_G37_OF_TRNA_PHE	Metabolism of RNA
REACTOME_INTERLEUKIN_6_SIGNALING	Immune System
REACTOME_IL_6_TYPE_CYTOKINE_RECEPTOR_LIGAND_INTERACTIONS	Immune System
REACTOME_TP53_REGULATES_TRANSCRIPTION_OF_GENES_INVOLVED_IN_G2_CELL_CYCLE_ARREST	Gene expression (Transcription)
REACTOME_TP53_REGULATES_TRANSCRIPTION_OF_ADDITIONAL_CELL_CYCLE_GENES_WHOSE_EXACT_ROLE_IN_THE_P53_PATHWAY_REMAIN_UNCERTAIN	Gene expression (Transcription)
REACTOME_TP53_REGULATES_TRANSCRIPTION_OF_GENES_INVOLVED_IN_G1_CELL_CYCLE_ARREST	Gene expression (Transcription)
REACTOME_RECEPTOR_TYPE_TYROSINE_PROTEIN_PHOSPHATASES	Neuronal System
REACTOME_NEUREXINS_AND_NEUROLIGINS	Neuronal System
REACTOME_SYNAPTIC_ADHESION_LIKE_MOLECULES	Neuronal System
REACTOME_SIGNALING_BY_MODERATE_KINASE_ACTIVITY_BRAF_MUTANTS	Disease
REACTOME_SIGNALING_BY_RAS_MUTANTS	Disease
REACTOME_SIGNALING_BY_BRAF_AND_RAF_FUSIONS	Disease
REACTOME_DEFENSINS	Immune System
REACTOME_METAL_SEQUESTRATION_BY_ANTIMICROBIAL_PROTEINS	Immune System
REACTOME_PI5P_REGULATES_TP53_ACETYLATION	Gene expression (Transcription)
REACTOME_FORMATION_OF_THE_CORNIFIED_ENVELOPE	Developmental Biology
REACTOME_MET_RECEPTOR_ACTIVATION	Signal Transduction
REACTOME_NEGATIVE_REGULATION_OF_MET_ACTIVITY	Signal Transduction
REACTOME_MET_ACTIVATES_RAS_SIGNALING	Signal Transduction
REACTOME_MET_ACTIVATES_PI3K_AKT_SIGNALING	Signal Transduction
REACTOME_MET_ACTIVATES_PTPN11	Signal Transduction
REACTOME_MET_RECEPTOR_RECYCLING	Signal Transduction
REACTOME_MET_PROMOTES_CELL_MOTILITY	Signal Transduction
REACTOME_REGULATION_OF_PTEN_MRNA_TRANSLATION	Signal Transduction
REACTOME_REGULATION_OF_PTEN_GENE_TRANSCRIPTION	Signal Transduction
REACTOME_REGULATION_OF_PTEN_LOCALIZATION	Signal Transduction
REACTOME_REGULATION_OF_PTEN_STABILITY_AND_ACTIVITY	Signal Transduction
REACTOME_INTRA_GOLGI_TRAFFIC	Vesicle-mediated transport
REACTOME_RETROGRADE_TRANSPORT_AT_THE_TRANS_GOLGI_NETWORK	Vesicle-mediated transport
REACTOME_GOLGI_TO_ER_RETROGRADE_TRANSPORT	Vesicle-mediated transport
REACTOME_ASSEMBLY_OF_THE_ORC_COMPLEX_AT_THE_ORIGIN_OF_REPLICATION	DNA Replication
REACTOME_CDC6_ASSOCIATION_WITH_THE_ORC:ORIGIN_COMPLEX	DNA Replication
REACTOME_GOLGI_CISTERNAE_PERICENTRIOLAR_STACK_REORGANIZATION	Cell Cycle
REACTOME_CONDENSATION_OF_PROPHASE_CHROMOSOMES	Cell Cycle
REACTOME_MASTL_FACILITATES_MITOTIC_PROGRESSION	Cell Cycle
REACTOME_NUCLEAR_ENVELOPE_BREAKDOWN	Cell Cycle
REACTOME_RESOLUTION_OF_SISTER_CHROMATID_COHESION	Cell Cycle
REACTOME_CONDENSATION_OF_PROMETAPHASE_CHROMOSOMES	Cell Cycle
REACTOME_RECRUITMENT_OF_NUMA_TO_MITOTIC_CENTROSOMES	Cell Cycle
REACTOME_NUCLEAR_ENVELOPE_REASSEMBLY	Cell Cycle
REACTOME_COHESIN_LOADING_ONTO_CHROMATIN	Cell Cycle
REACTOME_MITOTIC_METAPHASE_AND_ANAPHASE	Cell Cycle
REACTOME_MITOTIC_PROPHASE	Cell Cycle
REACTOME_MITOTIC_PROMETAPHASE	Cell Cycle
REACTOME_MITOTIC_TELOPHASE_CYTOKINESIS	Cell Cycle
REACTOME_ASSEMBLY_OF_THE_PRE_REPLICATIVE_COMPLEX	DNA Replication
REACTOME_ACTIVATION_OF_THE_PRE_REPLICATIVE_COMPLEX	Cell Cycle
REACTOME_ACTIVATION_OF_THE_PRE_REPLICATIVE_COMPLEX	DNA Replication
REACTOME_ORC1_REMOVAL_FROM_CHROMATIN	Cell Cycle
REACTOME_ORC1_REMOVAL_FROM_CHROMATIN	DNA Replication
REACTOME_CDK_MEDIATED_PHOSPHORYLATION_AND_REMOVAL_OF_CDC6	Cell Cycle
REACTOME_CDK_MEDIATED_PHOSPHORYLATION_AND_REMOVAL_OF_CDC6	DNA Replication
REACTOME_PROCESSIVE_SYNTHESIS_ON_THE_LAGGING_STRAND	Cell Cycle
REACTOME_PROCESSIVE_SYNTHESIS_ON_THE_LAGGING_STRAND	DNA Replication
REACTOME_UNWINDING_OF_DNA	Cell Cycle
REACTOME_UNWINDING_OF_DNA	DNA Replication
REACTOME_LEADING_STRAND_SYNTHESIS	Cell Cycle
REACTOME_LEADING_STRAND_SYNTHESIS	DNA Replication
REACTOME_LAGGING_STRAND_SYNTHESIS	Cell Cycle
REACTOME_LAGGING_STRAND_SYNTHESIS	DNA Replication
REACTOME_SCF_SKP2_MEDIATED_DEGRADATION_OF_P27_P21	Cell Cycle
REACTOME_E2F_MEDIATED_REGULATION_OF_DNA_REPLICATION	Cell Cycle
REACTOME_G1_S_SPECIFIC_TRANSCRIPTION	Cell Cycle
REACTOME_DNA_REPLICATION_INITIATION	Cell Cycle
REACTOME_DNA_REPLICATION_INITIATION	DNA Replication
REACTOME_SWITCHING_OF_ORIGINS_TO_A_POST_REPLICATIVE_STATE	Cell Cycle
REACTOME_SWITCHING_OF_ORIGINS_TO_A_POST_REPLICATIVE_STATE	DNA Replication
REACTOME_DNA_STRAND_ELONGATION	Cell Cycle
REACTOME_DNA_STRAND_ELONGATION	DNA Replication
REACTOME_ESTABLISHMENT_OF_SISTER_CHROMATID_COHESION	Cell Cycle
REACTOME_CYCLIN_A:CDK2_ASSOCIATED_EVENTS_AT_S_PHASE_ENTRY	Cell Cycle
REACTOME_POLO_LIKE_KINASE_MEDIATED_EVENTS	Cell Cycle
REACTOME_REGULATION_OF_PLK1_ACTIVITY_AT_G2_M_TRANSITION	Cell Cycle
REACTOME_CENTROSOME_MATURATION	Cell Cycle
REACTOME_CYCLIN_A_B1_B2_ASSOCIATED_EVENTS_DURING_G2_M_TRANSITION	Cell Cycle
REACTOME_THE_ROLE_OF_GTSE1_IN_G2_M_PROGRESSION_AFTER_G2_CHECKPOINT	Cell Cycle
REACTOME_FBXL7_DOWN_REGULATES_AURKA_DURING_MITOTIC_ENTRY_AND_IN_EARLY_MITOSIS	Cell Cycle
REACTOME_AURKA_ACTIVATION_BY_TPX2	Cell Cycle
REACTOME_MITOTIC_G2_G2_M_PHASES	Cell Cycle
REACTOME_REGULATION_OF_MITOTIC_CELL_CYCLE	Cell Cycle
REACTOME_M_PHASE	Cell Cycle
REACTOME_S_PHASE	Cell Cycle
REACTOME_DNA_REPLICATION_PRE_INITIATION	DNA Replication
REACTOME_CHK1_CHK2_CDS1_MEDIATED_INACTIVATION_OF_CYCLIN_B:CDK1_COMPLEX	Cell Cycle
REACTOME_ACTIVATION_OF_ATR_IN_RESPONSE_TO_REPLICATION_STRESS	Cell Cycle
REACTOME_G2_M_DNA_DAMAGE_CHECKPOINT	Cell Cycle
REACTOME_G2_M_DNA_REPLICATION_CHECKPOINT	Cell Cycle
REACTOME_STABILIZATION_OF_P53	Cell Cycle
REACTOME_G2_M_CHECKPOINTS	Cell Cycle
REACTOME_G1_S_DNA_DAMAGE_CHECKPOINTS	Cell Cycle
REACTOME_MITOTIC_SPINDLE_CHECKPOINT	Cell Cycle
REACTOME_REGULATION_OF_GLYCOLYSIS_BY_FRUCTOSE_2_6_BISPHOSPHATE_METABOLISM	Metabolism
REACTOME_REGULATION_OF_PYRUVATE_DEHYDROGENASE_PDH_COMPLEX	Metabolism
REACTOME_GLYCOLYSIS	Metabolism
REACTOME_GLUCONEOGENESIS	Metabolism
REACTOME_SULFUR_AMINO_ACID_METABOLISM	Metabolism
REACTOME_METABOLISM_OF_AMINE_DERIVED_HORMONES	Metabolism
REACTOME_SELENOAMINO_ACID_METABOLISM	Metabolism
REACTOME_METABOLISM_OF_POLYAMINES	Metabolism
REACTOME_GLYOXYLATE_METABOLISM_AND_GLYCINE_DEGRADATION	Metabolism
REACTOME_MELANIN_BIOSYNTHESIS	Metabolism
REACTOME_CHOLINE_CATABOLISM	Metabolism
REACTOME_UREA_CYCLE	Metabolism
REACTOME_BRANCHED_CHAIN_AMINO_ACID_CATABOLISM	Metabolism
REACTOME_HISTIDINE_CATABOLISM	Metabolism
REACTOME_LYSINE_CATABOLISM	Metabolism
REACTOME_TRYPTOPHAN_CATABOLISM	Metabolism
REACTOME_CREATINE_METABOLISM	Metabolism
REACTOME_PHENYLALANINE_AND_TYROSINE_METABOLISM	Metabolism
REACTOME_ASPARTATE_AND_ASPARAGINE_METABOLISM	Metabolism
REACTOME_GLUTAMATE_AND_GLUTAMINE_METABOLISM	Metabolism
REACTOME_SERINE_BIOSYNTHESIS	Metabolism
REACTOME_GLYCOSAMINOGLYCAN_METABOLISM	Metabolism
REACTOME_FRUCTOSE_METABOLISM	Metabolism
REACTOME_FORMATION_OF_XYLULOSE_5_PHOSPHATE	Metabolism
REACTOME_GLUCOSE_METABOLISM	Metabolism
REACTOME_GALACTOSE_CATABOLISM	Metabolism
REACTOME_PENTOSE_PHOSPHATE_PATHWAY	Metabolism
REACTOME_GLYCOGEN_METABOLISM	Metabolism
REACTOME_BLOOD_GROUP_SYSTEMS_BIOSYNTHESIS	Metabolism
REACTOME_PYRUVATE_METABOLISM	Metabolism
REACTOME_CITRIC_ACID_CYCLE_TCA_CYCLE	Metabolism
REACTOME_MRNA_SPLICING_MINOR_PATHWAY	Metabolism of RNA
REACTOME_TRANSPORT_OF_MATURE_MRNAS_DERIVED_FROM_INTRONLESS_TRANSCRIPTS	Metabolism of RNA
REACTOME_MRNA_SPLICING	Metabolism of RNA
REACTOME_TRANSPORT_OF_MATURE_TRANSCRIPT_TO_CYTOPLASM	Metabolism of RNA
REACTOME_TRNA_MODIFICATION_IN_THE_NUCLEUS_AND_CYTOSOL	Metabolism of RNA
REACTOME_TRNA_PROCESSING_IN_THE_NUCLEUS	Metabolism of RNA
REACTOME_TRNA_PROCESSING_IN_THE_MITOCHONDRION	Metabolism of RNA
REACTOME_TRNA_MODIFICATION_IN_THE_MITOCHONDRION	Metabolism of RNA
REACTOME_RRNA_PROCESSING_IN_THE_MITOCHONDRION	Metabolism of RNA
REACTOME_RRNA_PROCESSING_IN_THE_NUCLEUS_AND_CYTOSOL	Metabolism of RNA
REACTOME_ACTIVATION_OF_THE_MRNA_UPON_BINDING_OF_THE_CAP_BINDING_COMPLEX_AND_EIFS_AND_SUBSEQUENT_BINDING_TO_43S	Metabolism of proteins
REACTOME_RECYCLING_OF_EIF2:GDP	Metabolism of proteins
REACTOME_SRP_DEPENDENT_COTRANSLATIONAL_PROTEIN_TARGETING_TO_MEMBRANE	Metabolism of proteins
REACTOME_TRNA_AMINOACYLATION	Metabolism of proteins
REACTOME_MITOCHONDRIAL_TRANSLATION	Metabolism of proteins
REACTOME_EUKARYOTIC_TRANSLATION_INITIATION	Metabolism of proteins
REACTOME_RNA_POLYMERASE_I_TRANSCRIPTION_INITIATION	Gene expression (Transcription)
REACTOME_RNA_POLYMERASE_I_PROMOTER_ESCAPE	Gene expression (Transcription)
REACTOME_GENERIC_TRANSCRIPTION_PATHWAY	Gene expression (Transcription)
REACTOME_RNA_POLYMERASE_II_PRE_TRANSCRIPTION_EVENTS	Gene expression (Transcription)
REACTOME_RNA_POLYMERASE_II_TRANSCRIBES_SNRNA_GENES	Gene expression (Transcription)
REACTOME_RNA_POLYMERASE_II_TRANSCRIPTION_PRE_INITIATION_AND_PROMOTER_OPENING	Gene expression (Transcription)
REACTOME_RNA_POLYMERASE_II_TRANSCRIPTION_TERMINATION	Gene expression (Transcription)
REACTOME_RNA_POLYMERASE_II_TRANSCRIPTION_ELONGATION	Gene expression (Transcription)
REACTOME_RNA_POLYMERASE_I_TRANSCRIPTION_TERMINATION	Gene expression (Transcription)
REACTOME_BASE_EXCISION_REPAIR_AP_SITE_FORMATION	DNA Repair
REACTOME_RESOLUTION_OF_ABASIC_SITES_AP_SITES	DNA Repair
REACTOME_TELOMERE_MAINTENANCE	Cell Cycle
REACTOME_NUCLEOSOME_ASSEMBLY	Cell Cycle
REACTOME_P75_NTR_RECEPTOR_MEDIATED_SIGNALLING	Signal Transduction
REACTOME_FASL_CD95L_SIGNALING	Signal Transduction
REACTOME_TRAIL_SIGNALING	Signal Transduction
REACTOME_TNF_SIGNALING	Signal Transduction
REACTOME_TRANSLESION_SYNTHESIS_BY_Y_FAMILY_DNA_POLYMERASES_BYPASSES_LESIONS_ON_DNA_TEMPLATE	DNA Repair
REACTOME_RECOGNITION_OF_DNA_DAMAGE_BY_PCNA_CONTAINING_REPLICATION_COMPLEX	DNA Repair
REACTOME_MISMATCH_REPAIR	DNA Repair
REACTOME_DNA_DOUBLE_STRAND_BREAK_REPAIR	DNA Repair
REACTOME_NUCLEOTIDE_EXCISION_REPAIR	DNA Repair
REACTOME_FANCONI_ANEMIA_PATHWAY	DNA Repair
REACTOME_BASE_EXCISION_REPAIR	DNA Repair
REACTOME_DNA_DAMAGE_BYPASS	DNA Repair
REACTOME_DNA_DAMAGE_REVERSAL	DNA Repair
REACTOME_DEPURINATION	DNA Repair
REACTOME_DISPLACEMENT_OF_DNA_GLYCOSYLASE_BY_APEX1	DNA Repair
REACTOME_RESOLUTION_OF_AP_SITES_VIA_THE_MULTIPLE_NUCLEOTIDE_PATCH_REPLACEMENT_PATHWAY	DNA Repair
REACTOME_APEX1_INDEPENDENT_RESOLUTION_OF_AP_SITES_VIA_THE_SINGLE_NUCLEOTIDE_REPLACEMENT_PATHWAY	DNA Repair
REACTOME_RNA_POLYMERASE_III_CHAIN_ELONGATION	Gene expression (Transcription)
REACTOME_RNA_POLYMERASE_III_TRANSCRIPTION_TERMINATION	Gene expression (Transcription)
REACTOME_GENE_SILENCING_BY_RNA	Gene expression (Transcription)
REACTOME_EPIGENETIC_REGULATION_OF_GENE_EXPRESSION	Gene expression (Transcription)
REACTOME_RNA_POLYMERASE_I_TRANSCRIPTION	Gene expression (Transcription)
REACTOME_RNA_POLYMERASE_III_TRANSCRIPTION	Gene expression (Transcription)
REACTOME_SYNTHESIS_OF_KETONE_BODIES	Metabolism
REACTOME_PHOSPHATE_BOND_HYDROLYSIS_BY_NUDT_PROTEINS	Metabolism
REACTOME_IRS_ACTIVATION	Signal Transduction
REACTOME_SIGNAL_ATTENUATION	Signal Transduction
REACTOME_INSULIN_RECEPTOR_SIGNALLING_CASCADE	Signal Transduction
REACTOME_INSULIN_RECEPTOR_RECYCLING	Signal Transduction
REACTOME_SLBP_DEPENDENT_PROCESSING_OF_REPLICATION_DEPENDENT_HISTONE_PRE_MRNAS	Metabolism of RNA
REACTOME_PROCESSING_OF_INTRONLESS_PRE_MRNAS	Metabolism of RNA
REACTOME_MRNA_EDITING:_C_TO_U_CONVERSION	Metabolism of RNA
REACTOME_SYNTHESIS_OF_VERY_LONG_CHAIN_FATTY_ACYL_COAS	Metabolism
REACTOME_APOPTOTIC_CLEAVAGE_OF_CELLULAR_PROTEINS	Programmed Cell Death
REACTOME_APOPTOSIS_INDUCED_DNA_FRAGMENTATION	Programmed Cell Death
REACTOME_TNFR1_INDUCED_PROAPOPTOTIC_SIGNALING	Signal Transduction
REACTOME_REGULATION_OF_TNFR1_SIGNALING	Signal Transduction
REACTOME_TNFR1_INDUCED_NFKAPPAB_SIGNALING_PATHWAY	Signal Transduction
REACTOME_TNFR1_MEDIATED_CERAMIDE_PRODUCTION	Signal Transduction
REACTOME_FORMATION_OF_THE_EARLY_ELONGATION_COMPLEX	Gene expression (Transcription)
REACTOME_GPVI_MEDIATED_ACTIVATION_CASCADE	Hemostasis
REACTOME_SIGNAL_AMPLIFICATION	Hemostasis
REACTOME_GP1B_IX_V_ACTIVATION_SIGNALLING	Hemostasis
REACTOME_THROMBIN_SIGNALLING_THROUGH_PROTEINASE_ACTIVATED_RECEPTORS_PARS	Hemostasis
REACTOME_RESPONSE_TO_ELEVATED_PLATELET_CYTOSOLIC_CA2PLUS	Hemostasis
REACTOME_PLATELET_AGGREGATION_PLUG_FORMATION	Hemostasis
REACTOME_DISINHIBITION_OF_SNARE_FORMATION	Hemostasis
REACTOME_RNA_POLYMERASE_III_TRANSCRIPTION_INITIATION_FROM_TYPE_1_PROMOTER	Gene expression (Transcription)
REACTOME_RNA_POLYMERASE_III_TRANSCRIPTION_INITIATION_FROM_TYPE_3_PROMOTER	Gene expression (Transcription)
REACTOME_BETA_OXIDATION_OF_LAUROYL_COA_TO_DECANOYL_COA_COA	Metabolism
REACTOME_BETA_OXIDATION_OF_DECANOYL_COA_TO_OCTANOYL_COA_COA	Metabolism
REACTOME_BETA_OXIDATION_OF_OCTANOYL_COA_TO_HEXANOYL_COA	Metabolism
REACTOME_BETA_OXIDATION_OF_HEXANOYL_COA_TO_BUTANOYL_COA	Metabolism
REACTOME_BETA_OXIDATION_OF_BUTANOYL_COA_TO_ACETYL_COA	Metabolism
REACTOME_PROPIONYL_COA_CATABOLISM	Metabolism
REACTOME_MITOCHONDRIAL_FATTY_ACID_BETA_OXIDATION_OF_SATURATED_FATTY_ACIDS	Metabolism
REACTOME_MITOCHONDRIAL_FATTY_ACID_BETA_OXIDATION_OF_UNSATURATED_FATTY_ACIDS	Metabolism
REACTOME_REGULATION_OF_IFNG_SIGNALING	Immune System
REACTOME_EGFR_TRANSACTIVATION_BY_GASTRIN	Signal Transduction
REACTOME_PTK6_REGULATES_PROTEINS_INVOLVED_IN_RNA_PROCESSING	Signal Transduction
REACTOME_PTK6_REGULATES_RTKS_AND_THEIR_EFFECTORS_AKT1_AND_DOK1	Signal Transduction
REACTOME_PTK6_REGULATES_CELL_CYCLE	Signal Transduction
REACTOME_PTK6_REGULATES_RHO_GTPASES_RAS_GTPASE_AND_MAP_KINASES	Signal Transduction
REACTOME_PTK6_EXPRESSION	Signal Transduction
REACTOME_PTK6_PROMOTES_HIF1A_STABILIZATION	Signal Transduction
REACTOME_SYNTHESIS_OF_ACTIVE_UBIQUITIN:_ROLES_OF_E1_AND_E2_ENZYMES	Metabolism of proteins
REACTOME_E3_UBIQUITIN_LIGASES_UBIQUITINATE_TARGET_PROTEINS	Metabolism of proteins
REACTOME_COPI_DEPENDENT_GOLGI_TO_ER_RETROGRADE_TRAFFIC	Vesicle-mediated transport
REACTOME_COPI_INDEPENDENT_GOLGI_TO_ER_RETROGRADE_TRAFFIC	Vesicle-mediated transport
REACTOME_CARGO_RECOGNITION_FOR_CLATHRIN_MEDIATED_ENDOCYTOSIS	Vesicle-mediated transport
REACTOME_DOWNREGULATION_OF_ERBB2:ERBB3_SIGNALING	Signal Transduction
REACTOME_NEGATIVE_REGULATION_OF_ACTIVITY_OF_TFAP2_AP_2_FAMILY_TRANSCRIPTION_FACTORS	Gene expression (Transcription)
REACTOME_ACTIVATION_OF_THE_TFAP2_AP_2_FAMILY_OF_TRANSCRIPTION_FACTORS	Gene expression (Transcription)
REACTOME_TFAP2_AP_2_FAMILY_REGULATES_TRANSCRIPTION_OF_GROWTH_FACTORS_AND_THEIR_RECEPTORS	Gene expression (Transcription)
REACTOME_TFAP2_AP_2_FAMILY_REGULATES_TRANSCRIPTION_OF_CELL_CYCLE_FACTORS	Gene expression (Transcription)
REACTOME_TFAP2A_ACTS_AS_A_TRANSCRIPTIONAL_REPRESSOR_DURING_RETINOIC_ACID_INDUCED_CELL_DIFFERENTIATION	Gene expression (Transcription)
REACTOME_RRNA_MODIFICATION_IN_THE_MITOCHONDRION	Metabolism of RNA
REACTOME_RRNA_MODIFICATION_IN_THE_NUCLEUS_AND_CYTOSOL	Metabolism of RNA
REACTOME_MET_ACTIVATES_PTK2_SIGNALING	Signal Transduction
REACTOME_MET_INTERACTS_WITH_TNS_PROTEINS	Signal Transduction
REACTOME_MET_ACTIVATES_RAP1_AND_RAC1	Signal Transduction
REACTOME_INLB_MEDIATED_ENTRY_OF_LISTERIA_MONOCYTOGENES_INTO_HOST_CELL	Disease
REACTOME_INLA_MEDIATED_ENTRY_OF_LISTERIA_MONOCYTOGENES_INTO_HOST_CELLS	Disease
REACTOME_RUNX3_REGULATES_CDKN1A_TRANSCRIPTION	Gene expression (Transcription)
REACTOME_RUNX3_REGULATES_NOTCH_SIGNALING	Gene expression (Transcription)
REACTOME_REGULATION_OF_RUNX3_EXPRESSION_AND_ACTIVITY	Gene expression (Transcription)
REACTOME_RUNX3_REGULATES_IMMUNE_RESPONSE_AND_CELL_MIGRATION	Gene expression (Transcription)
REACTOME_RUNX3_REGULATES_WNT_SIGNALING	Gene expression (Transcription)
REACTOME_RUNX3_REGULATES_YAP1_MEDIATED_TRANSCRIPTION	Gene expression (Transcription)
REACTOME_RUNX3_REGULATES_P14_ARF	Gene expression (Transcription)
REACTOME_RUNX3_REGULATES_BCL2L11_BIM_TRANSCRIPTION	Gene expression (Transcription)
REACTOME_REGULATION_OF_RUNX2_EXPRESSION_AND_ACTIVITY	Gene expression (Transcription)
REACTOME_RUNX2_REGULATES_BONE_DEVELOPMENT	Gene expression (Transcription)
REACTOME_RUNX2_REGULATES_GENES_INVOLVED_IN_CELL_MIGRATION	Gene expression (Transcription)
REACTOME_RUNX1_AND_FOXP3_CONTROL_THE_DEVELOPMENT_OF_REGULATORY_T_LYMPHOCYTES_TREGS	Gene expression (Transcription)
REACTOME_RUNX1_REGULATES_ESTROGEN_RECEPTOR_MEDIATED_TRANSCRIPTION	Gene expression (Transcription)
REACTOME_REGULATION_OF_RUNX1_EXPRESSION_AND_ACTIVITY	Gene expression (Transcription)
REACTOME_RUNX1_REGULATES_EXPRESSION_OF_COMPONENTS_OF_TIGHT_JUNCTIONS	Gene expression (Transcription)
REACTOME_RUNX1_REGULATES_GENES_INVOLVED_IN_MEGAKARYOCYTE_DIFFERENTIATION_AND_PLATELET_FUNCTION	Gene expression (Transcription)
REACTOME_RUNX1_REGULATES_TRANSCRIPTION_OF_GENES_INVOLVED_IN_DIFFERENTIATION_OF_HSCS	Gene expression (Transcription)
REACTOME_RUNX1_REGULATES_TRANSCRIPTION_OF_GENES_INVOLVED_IN_DIFFERENTIATION_OF_KERATINOCYTES	Gene expression (Transcription)
REACTOME_RUNX1_INTERACTS_WITH_CO_FACTORS_WHOSE_PRECISE_EFFECT_ON_RUNX1_TARGETS_IS_NOT_KNOWN	Gene expression (Transcription)
REACTOME_RUNX1_REGULATES_TRANSCRIPTION_OF_GENES_INVOLVED_IN_BCR_SIGNALING	Gene expression (Transcription)
REACTOME_RUNX1_REGULATES_TRANSCRIPTION_OF_GENES_INVOLVED_IN_DIFFERENTIATION_OF_MYELOID_CELLS	Gene expression (Transcription)
REACTOME_RUNX1_REGULATES_TRANSCRIPTION_OF_GENES_INVOLVED_IN_INTERLEUKIN_SIGNALING	Gene expression (Transcription)
REACTOME_RUNX1_REGULATES_TRANSCRIPTION_OF_GENES_INVOLVED_IN_WNT_SIGNALING	Gene expression (Transcription)
REACTOME_DIGESTION_OF_DIETARY_CARBOHYDRATE	Digestion and absorption
REACTOME_DIGESTION_OF_DIETARY_LIPID	Digestion and absorption
REACTOME_EXTRA_NUCLEAR_ESTROGEN_SIGNALING	Signal Transduction
REACTOME_ESTROGEN_DEPENDENT_GENE_EXPRESSION	Signal Transduction
REACTOME_RUNX2_REGULATES_OSTEOBLAST_DIFFERENTIATION	Gene expression (Transcription)
REACTOME_RUNX2_REGULATES_CHONDROCYTE_MATURATION	Gene expression (Transcription)
REACTOME_COMPETING_ENDOGENOUS_RNAS_CERNAS_REGULATE_PTEN_TRANSLATION	Signal Transduction
REACTOME_PROCESSING_OF_SMDT1	Transport of small molecules
REACTOME_METABOLISM_OF_NON_CODING_RNA	Metabolism of RNA
REACTOME_DEADENYLATION_DEPENDENT_MRNA_DECAY	Metabolism of RNA
REACTOME_REGULATION_OF_MRNA_STABILITY_BY_PROTEINS_THAT_BIND_AU_RICH_ELEMENTS	Metabolism of RNA
REACTOME_MRNA_CAPPING	Metabolism of RNA
REACTOME_PROCESSING_OF_CAPPED_INTRON_CONTAINING_PRE_MRNA	Metabolism of RNA
REACTOME_TRNA_PROCESSING	Metabolism of RNA
REACTOME_RRNA_PROCESSING	Metabolism of RNA
REACTOME_PROCESSING_OF_CAPPED_INTRONLESS_PRE_MRNA	Metabolism of RNA
REACTOME_MRNA_EDITING	Metabolism of RNA
REACTOME_NONSENSE_MEDIATED_DECAY_NMD	Metabolism of RNA
REACTOME_CELLULAR_RESPONSES_TO_STRESS	Cellular responses to external stimuli
REACTOME_RESPONSE_TO_METAL_IONS	Cellular responses to external stimuli
REACTOME_PYRIMIDINE_CATABOLISM	Metabolism
REACTOME_PURINE_CATABOLISM	Metabolism
REACTOME_PHOSPHATE_BOND_HYDROLYSIS_BY_NTPDASE_PROTEINS	Metabolism
REACTOME_PURINE_RIBONUCLEOSIDE_MONOPHOSPHATE_BIOSYNTHESIS	Metabolism
REACTOME_PYRIMIDINE_SALVAGE	Metabolism
REACTOME_PURINE_SALVAGE	Metabolism
REACTOME_REGULATION_OF_CHOLESTEROL_BIOSYNTHESIS_BY_SREBP_SREBF	Metabolism
REACTOME_CHOLESTEROL_BIOSYNTHESIS	Metabolism
REACTOME_BILE_ACID_AND_BILE_SALT_METABOLISM	Metabolism
REACTOME_METABOLISM_OF_STEROID_HORMONES	Metabolism
REACTOME_VITAMIN_D_CALCIFEROL_METABOLISM	Metabolism
REACTOME_TYROSINE_CATABOLISM	Metabolism
REACTOME_PHENYLALANINE_METABOLISM	Metabolism
REACTOME_DIGESTION	Digestion and absorption
REACTOME_INTESTINAL_ABSORPTION	Digestion and absorption
REACTOME_VLDL_ASSEMBLY	Transport of small molecules
REACTOME_CHYLOMICRON_ASSEMBLY	Transport of small molecules
REACTOME_HDL_ASSEMBLY	Transport of small molecules
REACTOME_ASSEMBLY_OF_ACTIVE_LPL_AND_LIPC_LIPASE_COMPLEXES	Transport of small molecules
REACTOME_CHYLOMICRON_REMODELING	Transport of small molecules
REACTOME_HDL_REMODELING	Transport of small molecules
REACTOME_VLDLR_INTERNALISATION_AND_DEGRADATION	Transport of small molecules
REACTOME_HDL_CLEARANCE	Transport of small molecules
REACTOME_CHYLOMICRON_CLEARANCE	Transport of small molecules
REACTOME_LDL_CLEARANCE	Transport of small molecules
REACTOME_VLDL_CLEARANCE	Transport of small molecules
REACTOME_ALPHA_LINOLENIC_OMEGA3_AND_LINOLEIC_OMEGA6_ACID_METABOLISM	Metabolism
REACTOME_ARACHIDONIC_ACID_METABOLISM	Metabolism
REACTOME_PEROXISOMAL_LIPID_METABOLISM	Metabolism
REACTOME_FATTY_ACYL_COA_BIOSYNTHESIS	Metabolism
REACTOME_MITOCHONDRIAL_FATTY_ACID_BETA_OXIDATION	Metabolism
REACTOME_TETRAHYDROBIOPTERIN_BH4_SYNTHESIS_RECYCLING_SALVAGE_AND_REGULATION	Metabolism
REACTOME_UBIQUINOL_BIOSYNTHESIS	Metabolism
REACTOME_TRIGLYCERIDE_CATABOLISM	Metabolism
REACTOME_TRIGLYCERIDE_BIOSYNTHESIS	Metabolism
REACTOME_GLYCOGEN_SYNTHESIS	Metabolism
REACTOME_REGULATION_OF_MECP2_EXPRESSION_AND_ACTIVITY	Gene expression (Transcription)
REACTOME_MECP2_REGULATES_NEURONAL_RECEPTORS_AND_CHANNELS	Gene expression (Transcription)
REACTOME_MECP2_REGULATES_TRANSCRIPTION_OF_NEURONAL_LIGANDS	Gene expression (Transcription)
REACTOME_MECP2_REGULATES_TRANSCRIPTION_FACTORS	Gene expression (Transcription)
REACTOME_LOSS_OF_MECP2_BINDING_ABILITY_TO_THE_NCOR_SMRT_COMPLEX	Disease
REACTOME_ACTIVATED_NTRK2_SIGNALS_THROUGH_RAS	Signal Transduction
REACTOME_ACTIVATED_NTRK2_SIGNALS_THROUGH_PI3K	Signal Transduction
REACTOME_ACTIVATED_NTRK2_SIGNALS_THROUGH_FRS2_AND_FRS3	Signal Transduction
REACTOME_ACTIVATED_NTRK2_SIGNALS_THROUGH_FYN	Signal Transduction
REACTOME_ACTIVATED_NTRK2_SIGNALS_THROUGH_CDK5	Signal Transduction
REACTOME_ERYTHROPOIETIN_ACTIVATES_PHOSPHOINOSITIDE_3_KINASE_PI3K	Signal Transduction
REACTOME_ERYTHROPOIETIN_ACTIVATES_PHOSPHOLIPASE_C_GAMMA_PLCG	Signal Transduction
REACTOME_ERYTHROPOIETIN_ACTIVATES_STAT5	Signal Transduction
REACTOME_ERYTHROPOIETIN_ACTIVATES_RAS	Signal Transduction
REACTOME_DAG_AND_IP3_SIGNALING	Signal Transduction
REACTOME_SIGNALING_BY_RETINOIC_ACID	Signal Transduction
REACTOME_ESR_MEDIATED_SIGNALING	Signal Transduction
REACTOME_SIGNALING_BY_ERBB2	Signal Transduction
REACTOME_SIGNALING_BY_ERBB4	Signal Transduction
REACTOME_SIGNALING_BY_SCF_KIT	Signal Transduction
REACTOME_SIGNALING_BY_NTRKS	Signal Transduction
REACTOME_SIGNALING_BY_EGFR	Signal Transduction
REACTOME_SIGNALING_BY_PDGF	Signal Transduction
REACTOME_SIGNALING_BY_FGFR	Signal Transduction
REACTOME_SIGNALING_BY_VEGF	Signal Transduction
REACTOME_SIGNALING_BY_TYPE_1_INSULIN_LIKE_GROWTH_FACTOR_1_RECEPTOR_IGF1R	Signal Transduction
REACTOME_SIGNALING_BY_MET	Signal Transduction
REACTOME_SIGNALING_BY_INSULIN_RECEPTOR	Signal Transduction
REACTOME_SIGNALING_BY_MST1	Signal Transduction
REACTOME_SIGNALING_BY_ACTIVIN	Signal Transduction
REACTOME_SIGNALING_BY_TGF_BETA_RECEPTOR_COMPLEX	Signal Transduction
REACTOME_SIGNALING_BY_BMP	Signal Transduction
REACTOME_TBC_RABGAPS	Vesicle-mediated transport
REACTOME_RAB_GEFS_EXCHANGE_GTP_FOR_GDP_ON_RABS	Vesicle-mediated transport
REACTOME_ESTROGEN_STIMULATED_SIGNALING_THROUGH_PRKCZ	Signal Transduction
REACTOME_ESTROGEN_DEPENDENT_NUCLEAR_EVENTS_DOWNSTREAM_OF_ESR_MEMBRANE_SIGNALING	Signal Transduction
REACTOME_ER_QUALITY_CONTROL_COMPARTMENT_ERQC	Metabolism of proteins
REACTOME_NOTCH3_ACTIVATION_AND_TRANSMISSION_OF_SIGNAL_TO_THE_NUCLEUS	Signal Transduction
REACTOME_NOTCH3_INTRACELLULAR_DOMAIN_REGULATES_TRANSCRIPTION	Signal Transduction
REACTOME_NONCANONICAL_ACTIVATION_OF_NOTCH3	Signal Transduction
REACTOME_NOTCH4_INTRACELLULAR_DOMAIN_REGULATES_TRANSCRIPTION	Signal Transduction
REACTOME_NOTCH4_ACTIVATION_AND_TRANSMISSION_OF_SIGNAL_TO_THE_NUCLEUS	Signal Transduction
REACTOME_NEGATIVE_REGULATION_OF_NOTCH4_SIGNALING	Signal Transduction
REACTOME_BIOSYNTHESIS_OF_MARESINS	Metabolism
REACTOME_SYNTHESIS_OF_LIPOXINS_LX	Metabolism
REACTOME_BIOSYNTHESIS_OF_EPA_DERIVED_SPMS	Metabolism
REACTOME_BIOSYNTHESIS_OF_E_SERIES_18_S_RESOLVINS	Metabolism
REACTOME_BIOSYNTHESIS_OF_MARESIN_LIKE_SPMS	Metabolism
REACTOME_GENE_AND_PROTEIN_EXPRESSION_BY_JAK_STAT_SIGNALING_AFTER_INTERLEUKIN_12_STIMULATION	Immune System
REACTOME_NTRK2_ACTIVATES_RAC1	Signal Transduction
REACTOME_TYSND1_CLEAVES_PEROXISOMAL_PROTEINS	Protein localization
REACTOME_ACTIVATED_NTRK3_SIGNALS_THROUGH_RAS	Signal Transduction
REACTOME_ACTIVATED_NTRK3_SIGNALS_THROUGH_PI3K	Signal Transduction
REACTOME_REGULATION_OF_IFNA_SIGNALING	Immune System
REACTOME_ANTIVIRAL_MECHANISM_BY_IFN_STIMULATED_GENES	Immune System
REACTOME_INTERFERON_GAMMA_SIGNALING	Immune System
REACTOME_INTERFERON_ALPHA_BETA_SIGNALING	Immune System
REACTOME_TERMINATION_OF_O_GLYCAN_BIOSYNTHESIS	Metabolism of proteins
REACTOME_TRANSFERRIN_ENDOCYTOSIS_AND_RECYCLING	Transport of small molecules
REACTOME_NONSENSE_MEDIATED_DECAY_NMD_INDEPENDENT_OF_THE_EXON_JUNCTION_COMPLEX_EJC	Metabolism of RNA
REACTOME_TRIF_MEDIATED_PROGRAMMED_CELL_DEATH	Immune System
REACTOME_ACTIVATION_OF_IRF3_IRF7_MEDIATED_BY_TBK1_IKK_EPSILON	Immune System
REACTOME_IKK_COMPLEX_RECRUITMENT_MEDIATED_BY_RIP1	Immune System
REACTOME_TRAF6_MEDIATED_INDUCTION_OF_TAK1_COMPLEX_WITHIN_TLR4_COMPLEX	Immune System
REACTOME_N_GLYCAN_TRIMMING_AND_ELONGATION_IN_THE_CIS_GOLGI	Metabolism of proteins
REACTOME_N_GLYCAN_ANTENNAE_ELONGATION_IN_THE_MEDIAL_TRANS_GOLGI	Metabolism of proteins
REACTOME_STAT5_ACTIVATION	Immune System
REACTOME_MITOCHONDRIAL_PROTEIN_IMPORT	Protein localization
REACTOME_PEROXISOMAL_PROTEIN_IMPORT	Protein localization
REACTOME_CLASS_I_PEROXISOMAL_MEMBRANE_PROTEIN_IMPORT	Protein localization
REACTOME_INSERTION_OF_TAIL_ANCHORED_PROTEINS_INTO_THE_ENDOPLASMIC_RETICULUM_MEMBRANE	Protein localization
REACTOME_MACROAUTOPHAGY	Autophagy
REACTOME_CHAPERONE_MEDIATED_AUTOPHAGY	Autophagy
REACTOME_REGULATION_OF_LOCALIZATION_OF_FOXO_TRANSCRIPTION_FACTORS	Gene expression (Transcription)
REACTOME_FOXO_MEDIATED_TRANSCRIPTION_OF_CELL_DEATH_GENES	Gene expression (Transcription)
REACTOME_FOXO_MEDIATED_TRANSCRIPTION_OF_OXIDATIVE_STRESS_METABOLIC_AND_NEURONAL_GENES	Gene expression (Transcription)
REACTOME_REGULATION_OF_FOXO_TRANSCRIPTIONAL_ACTIVITY_BY_ACETYLATION	Gene expression (Transcription)
REACTOME_FOXO_MEDIATED_TRANSCRIPTION_OF_CELL_CYCLE_GENES	Gene expression (Transcription)
REACTOME_MITOPHAGY	Autophagy
REACTOME_LIPOPHAGY	Autophagy
REACTOME_TRAF6_MEDIATED_IRF7_ACTIVATION_IN_TLR7_8_OR_9_SIGNALING	Immune System
REACTOME_N_GLYCAN_ANTENNAE_ELONGATION	Metabolism of proteins
REACTOME_REACTIONS_SPECIFIC_TO_THE_COMPLEX_N_GLYCAN_SYNTHESIS_PATHWAY	Metabolism of proteins
REACTOME_GABA_B_RECEPTOR_ACTIVATION	Neuronal System
REACTOME_ANTIGEN_PROCESSING_CROSS_PRESENTATION	Immune System
REACTOME_ANTIGEN_PROCESSING:_UBIQUITINATION_PROTEASOME_DEGRADATION	Immune System
REACTOME_ANTIGEN_PRESENTATION:_FOLDING_ASSEMBLY_AND_PEPTIDE_LOADING_OF_CLASS_I_MHC	Immune System
REACTOME_KINESINS	Hemostasis
REACTOME_DOWNSTREAM_SIGNALING_EVENTS_OF_B_CELL_RECEPTOR_BCR	Immune System
REACTOME_CD22_MEDIATED_BCR_REGULATION	Immune System
REACTOME_ANTIGEN_ACTIVATES_B_CELL_RECEPTOR_BCR_LEADING_TO_GENERATION_OF_SECOND_MESSENGERS	Immune System
REACTOME_STIMULI_SENSING_CHANNELS	Transport of small molecules
REACTOME_ION_TRANSPORT_BY_P_TYPE_ATPASES	Transport of small molecules
REACTOME_PROGRAMMED_CELL_DEATH	Programmed Cell Death
REACTOME_HEMOSTASIS	Hemostasis
REACTOME_DNA_REPAIR	DNA Repair
REACTOME_NEURONAL_SYSTEM	Neuronal System
REACTOME_CELL_CYCLE	Cell Cycle
REACTOME_DEVELOPMENTAL_BIOLOGY	Developmental Biology
REACTOME_REPRODUCTION	Reproduction
REACTOME_DISEASE	Disease
REACTOME_CELLULAR_RESPONSES_TO_EXTERNAL_STIMULI	Cellular responses to external stimuli
REACTOME_EXTRACELLULAR_MATRIX_ORGANIZATION	Extracellular matrix organization
REACTOME_TRANSPORT_OF_SMALL_MOLECULES	Transport of small molecules
REACTOME_CELL_CELL_COMMUNICATION	Cell-Cell communication
REACTOME_VESICLE_MEDIATED_TRANSPORT	Vesicle-mediated transport
REACTOME_ORGANELLE_BIOGENESIS_AND_MAINTENANCE	Organelle biogenesis and maintenance
REACTOME_METABOLISM_OF_RNA	Metabolism of RNA
REACTOME_AUTOPHAGY	Autophagy
REACTOME_GENE_EXPRESSION_TRANSCRIPTION	Gene expression (Transcription)
REACTOME_CHROMATIN_ORGANIZATION	Chromatin organization
REACTOME_MUSCLE_CONTRACTION	Muscle contraction
REACTOME_CIRCADIAN_CLOCK	Circadian Clock
REACTOME_DNA_REPLICATION	DNA Replication
REACTOME_DIGESTION_AND_ABSORPTION	Digestion and absorption
REACTOME_PROTEIN_LOCALIZATION	Protein localization
